一	一
乙	乙
二	二
十	十
丁	丁
厂	廠
七	七
卜	卜
八	八
人	人
入	入
儿	兒
匕	匕
几	幾
九	九
刁	刁
了	了
刀	刀
力	力
乃	乃
又	又
三	三
干	干
于	於
亏	虧
工	工
土	土
士	士
才	才
下	下
寸	寸
大	大
丈	丈
与	與
万	萬
上	上
小	小
口	口
山	山
巾	巾
千	千
乞	乞
川	川
亿	億
个	個
夕	夕
久	久
么	麼
勺	勺
凡	凡
丸	丸
及	及
广	廣
亡	亡
门	門
丫	丫
义	義
之	之
尸	屍
己	己
已	已
巳	巳
弓	弓
子	子
卫	衛
也	也
女	女
刃	刃
飞	飛
习	習
叉	叉
马	馬
乡	鄉
丰	豐
王	王
开	開
井	井
天	天
夫	夫
元	元
无	無
云	雲
专	專
丐	丐
扎	扎
艺	藝
木	木
五	五
支	支
厅	廳
不	不
犬	犬
太	太
区	區
历	歷
歹	歹
友	友
尤	尤
匹	匹
车	車
巨	巨
牙	牙
屯	屯
戈	戈
比	比
互	互
切	切
瓦	瓦
止	止
少	少
曰	曰
日	日
中	中
贝	貝
冈	岡
内	內
水	水
见	見
午	午
牛	牛
手	手
气	氣
毛	毛
壬	壬
升	升
夭	夭
长	長
仁	仁
什	什
片	片
仆	仆
化	化
仇	仇
币	幣
仍	仍
仅	僅
斤	斤
爪	爪
反	反
介	介
父	父
从	從
仑	侖
今	今
凶	凶
分	分
乏	乏
公	公
仓	倉
月	月
氏	氏
勿	勿
欠	欠
风	風
丹	丹
匀	勻
乌	烏
勾	勾
凤	鳳
六	六
文	文
亢	亢
方	方
火	火
为	為
斗	斗
忆	憶
计	計
订	訂
户	戶
认	認
冗	冗
讥	譏
心	心
尺	尺
引	引
丑	丑
巴	巴
孔	孔
队	隊
办	辦
以	以
允	允
予	予
邓	鄧
劝	勸
双	雙
书	書
幻	幻
玉	玉
刊	刊
未	未
末	末
示	示
击	擊
打	打
巧	巧
正	正
扑	撲
卉	卉
扒	扒
功	功
扔	扔
去	去
甘	甘
世	世
艾	艾
古	古
节	節
本	本
术	術
可	可
丙	丙
左	左
厉	厲
石	石
右	右
布	布
夯	夯
戊	戊
龙	龍
平	平
灭	滅
轧	軋
东	東
卡	卡
北	北
占	占
凸	凸
卢	盧
业	業
旧	舊
帅	帥
归	歸
旦	旦
目	目
且	且
叶	葉
甲	甲
申	申
叮	叮
电	電
号	號
田	田
由	由
只	只
叭	叭
史	史
央	央
兄	兄
叽	嘰
叼	叼
叫	叫
叩	叩
叨	叨
另	另
叹	嘆
冉	冉
皿	皿
凹	凹
囚	囚
四	四
生	生
矢	矢
失	失
乍	乍
禾	禾
丘	丘
付	付
仗	仗
代	代
仙	仙
们	們
仪	儀
白	白
仔	仔
他	他
斥	斥
瓜	瓜
乎	乎
丛	叢
令	令
用	用
甩	甩
印	印
尔	爾
乐	樂
句	句
匆	匆
册	冊
卯	卯
犯	犯
外	外
处	處
冬	冬
鸟	鳥
务	務
包	包
饥	飢
主	主
市	市
立	立
冯	馮
玄	玄
闪	閃
兰	蘭
半	半
汁	汁
汇	匯
头	頭
汉	漢
宁	寧
穴	穴
它	它
讨	討
写	寫
让	讓
礼	禮
训	訓
议	議
必	必
讯	訊
记	記
永	永
司	司
尼	尼
民	民
弗	弗
弘	弘
出	出
辽	遼
奶	奶
奴	奴
召	召
加	加
皮	皮
边	邊
孕	孕
发	發
圣	聖
对	對
台	台
矛	矛
纠	糾
母	母
幼	幼
丝	絲
邦	邦
式	式
迂	迂
刑	刑
戎	戎
动	動
扛	扛
寺	寺
吉	吉
扣	扣
考	考
托	托
老	老
巩	鞏
圾	圾
执	執
扩	擴
扫	掃
地	地
场	場
扬	揚
耳	耳
芋	芋
共	共
芒	芒
亚	亞
芝	芝
朽	朽
朴	樸
机	機
权	權
过	過
臣	臣
吏	吏
再	再
协	協
西	西
压	壓
厌	厭
戌	戌
在	在
百	百
有	有
存	存
而	而
页	頁
匠	匠
夸	夸
夺	奪
灰	灰
达	達
列	列
死	死
成	成
夹	夾
夷	夷
轨	軌
邪	邪
尧	堯
划	劃
迈	邁
毕	畢
至	至
此	此
贞	貞
师	師
尘	塵
尖	尖
劣	劣
光	光
当	當
早	早
吁	吁
吐	吐
吓	嚇
虫	蟲
曲	曲
团	團
吕	呂
同	同
吊	吊
吃	吃
因	因
吸	吸
吗	嗎
吆	吆
屿	嶼
屹	屹
岁	歲
帆	帆
回	回
岂	豈
则	則
刚	剛
网	網
肉	肉
年	年
朱	朱
先	先
丢	丟
廷	廷
舌	舌
竹	竹
迁	遷
乔	喬
迄	迄
伟	偉
传	傳
乒	乒
乓	乓
休	休
伍	伍
伏	伏
优	優
臼	臼
伐	伐
延	延
仲	仲
件	件
任	任
伤	傷
价	價
伦	倫
份	份
华	華
仰	仰
仿	仿
伙	伙
伪	偽
自	自
伊	伊
血	血
向	向
似	似
后	後
行	行
舟	舟
全	全
会	會
杀	殺
合	合
兆	兆
企	企
众	眾
爷	爺
伞	傘
创	創
肌	肌
肋	肋
朵	朵
杂	雜
危	危
旬	旬
旨	旨
旭	旭
负	負
匈	匈
名	名
各	各
多	多
争	爭
色	色
壮	壯
冲	沖
妆	妝
冰	冰
庄	莊
庆	慶
亦	亦
刘	劉
齐	齊
交	交
衣	衣
次	次
产	產
决	決
亥	亥
充	充
妄	妄
闭	閉
问	問
闯	闖
羊	羊
并	並
关	關
米	米
灯	燈
州	州
汗	汗
污	汙
江	江
汛	汛
池	池
汝	汝
汤	湯
忙	忙
兴	興
宇	宇
守	守
宅	宅
字	字
安	安
讲	講
讳	諱
军	軍
讶	訝
许	許
讹	訛
论	論
讼	訟
农	農
讽	諷
设	設
访	訪
诀	訣
寻	尋
那	那
迅	迅
尽	盡
导	導
异	異
弛	弛
孙	孫
阵	陣
阳	陽
收	收
阶	階
阴	陰
防	防
奸	奸
如	如
妇	婦
妃	妃
好	好
她	她
妈	媽
戏	戲
羽	羽
观	觀
欢	歡
买	買
红	紅
驮	馱
纤	纖
驯	馴
约	約
级	級
纪	紀
驰	馳
纫	紉
巡	巡
寿	壽
弄	弄
麦	麥
玖	玖
玛	瑪
形	形
进	進
戒	戒
吞	吞
远	遠
违	違
韧	韌
运	運
扶	扶
抚	撫
坛	壇
技	技
坏	壞
抠	摳
扰	擾
扼	扼
拒	拒
找	找
批	批
址	址
扯	扯
走	走
抄	抄
贡	貢
汞	汞
坝	壩
攻	攻
赤	赤
折	折
抓	抓
扳	扳
抡	掄
扮	扮
抢	搶
孝	孝
坎	坎
均	均
抑	抑
抛	拋
投	投
坟	墳
坑	坑
抗	抗
坊	坊
抖	抖
护	護
壳	殼
志	志
块	塊
扭	扭
声	聲
把	把
报	報
拟	擬
却	卻
抒	抒
劫	劫
芙	芙
芜	蕪
苇	葦
芽	芽
花	花
芹	芹
芥	芥
芬	芬
苍	蒼
芳	芳
严	嚴
芦	蘆
芯	芯
劳	勞
克	克
芭	芭
苏	蘇
杆	杆
杠	槓
杜	杜
材	材
村	村
杖	杖
杏	杏
杉	杉
巫	巫
极	極
李	李
杨	楊
求	求
甫	甫
匣	匣
更	更
束	束
吾	吾
豆	豆
两	兩
酉	酉
丽	麗
医	醫
辰	辰
励	勵
否	否
还	還
尬	尬
歼	殲
来	來
连	連
轩	軒
步	步
卤	鹵
坚	堅
肖	肖
旱	旱
盯	盯
呈	呈
时	時
吴	吳
助	助
县	縣
里	里
呆	呆
吱	吱
吠	吠
呕	嘔
园	園
旷	曠
围	圍
呀	呀
吨	噸
足	足
邮	郵
男	男
困	困
吵	吵
串	串
员	員
呐	吶
听	聽
吟	吟
吩	吩
呛	嗆
吻	吻
吹	吹
呜	嗚
吭	吭
吧	吧
邑	邑
吼	吼
囤	囤
别	別
吮	吮
岖	嶇
岗	崗
帐	帳
财	財
针	針
钉	釘
牡	牡
告	告
我	我
乱	亂
利	利
秃	禿
秀	秀
私	私
每	每
兵	兵
估	估
体	體
何	何
佐	佐
佑	佑
但	但
伸	伸
佃	佃
作	作
伯	伯
伶	伶
佣	傭
低	低
你	你
住	住
位	位
伴	伴
身	身
皂	皂
伺	伺
佛	佛
囱	囪
近	近
彻	徹
役	役
返	返
余	余
希	希
坐	坐
谷	谷
妥	妥
含	含
邻	鄰
岔	岔
肝	肝
肛	肛
肚	肚
肘	肘
肠	腸
龟	龜
甸	甸
免	免
狂	狂
犹	猶
狈	狽
角	角
删	刪
条	條
彤	彤
卵	卵
灸	灸
岛	島
刨	刨
迎	迎
饭	飯
饮	飲
系	系
言	言
冻	凍
状	狀
亩	畝
况	況
床	床
库	庫
庇	庇
疗	療
吝	吝
应	應
这	這
冷	冷
庐	廬
序	序
辛	辛
弃	棄
冶	冶
忘	忘
闰	閏
闲	閒
间	間
闷	悶
判	判
兑	兌
灶	灶
灿	燦
灼	灼
弟	弟
汪	汪
沐	沐
沛	沛
汰	汰
沥	瀝
沙	沙
汽	汽
沃	沃
沦	淪
汹	洶
泛	泛
沧	滄
没	沒
沟	溝
沪	滬
沈	沈
沉	沉
沁	沁
怀	懷
忧	憂
忱	忱
快	快
完	完
宋	宋
宏	宏
牢	牢
究	究
穷	窮
灾	災
良	良
证	證
启	啟
评	評
补	補
初	初
社	社
祀	祀
识	識
诈	詐
诉	訴
罕	罕
诊	診
词	詞
译	譯
君	君
灵	靈
即	即
层	層
屁	屁
尿	尿
尾	尾
迟	遲
局	局
改	改
张	張
忌	忌
际	際
陆	陸
阿	阿
陈	陳
阻	阻
附	附
坠	墜
妓	妓
妙	妙
妖	妖
姊	姊
妨	妨
妒	妒
努	努
忍	忍
劲	勁
矣	矣
鸡	雞
纬	緯
驱	驅
纯	純
纱	紗
纲	綱
纳	納
驳	駁
纵	縱
纷	紛
纸	紙
纹	紋
纺	紡
驴	驢
纽	紐
奉	奉
玩	玩
环	環
武	武
青	青
责	責
现	現
玫	玫
表	表
规	規
抹	抹
卦	卦
坷	坷
坯	坯
拓	拓
拢	攏
拔	拔
坪	坪
拣	揀
坦	坦
担	擔
坤	坤
押	押
抽	抽
拐	拐
拖	拖
者	者
拍	拍
顶	頂
拆	拆
拎	拎
拥	擁
抵	抵
拘	拘
势	勢
抱	抱
拄	拄
垃	垃
拉	拉
拦	攔
幸	幸
拌	拌
拧	擰
拂	拂
拙	拙
招	招
坡	坡
披	披
拨	撥
择	擇
抬	抬
拇	拇
拗	拗
其	其
取	取
茉	茉
苦	苦
昔	昔
苛	苛
若	若
茂	茂
苹	蘋
苗	苗
英	英
苟	苟
苑	苑
苞	苞
范	範
直	直
茁	茁
茄	茄
茎	莖
苔	苔
茅	茅
枉	枉
林	林
枝	枝
杯	杯
枢	樞
柜	櫃
枚	枚
析	析
板	板
松	松
枪	槍
枫	楓
构	構
杭	杭
杰	傑
述	述
枕	枕
丧	喪
或	或
画	畫
卧	臥
事	事
刺	刺
枣	棗
雨	雨
卖	賣
郁	鬱
矾	礬
矿	礦
码	碼
厕	廁
奈	奈
奔	奔
奇	奇
奋	奮
态	態
欧	歐
殴	毆
垄	壟
妻	妻
轰	轟
顷	頃
转	轉
斩	斬
轮	輪
软	軟
到	到
非	非
叔	叔
歧	歧
肯	肯
齿	齒
些	些
卓	卓
虎	虎
虏	虜
肾	腎
贤	賢
尚	尚
旺	旺
具	具
味	味
果	果
昆	昆
国	國
哎	哎
咕	咕
昌	昌
呵	呵
畅	暢
明	明
易	易
咙	嚨
昂	昂
迪	迪
典	典
固	固
忠	忠
呻	呻
咒	咒
咋	咋
咐	咐
呼	呼
鸣	鳴
咏	詠
呢	呢
咄	咄
咖	咖
岸	岸
岩	岩
帖	帖
罗	羅
帜	幟
帕	帕
岭	嶺
凯	凱
败	敗
账	賬
贩	販
贬	貶
购	購
贮	貯
图	圖
钓	釣
制	制
知	知
迭	迭
氛	氛
垂	垂
牧	牧
物	物
乖	乖
刮	刮
秆	稈
和	和
季	季
委	委
秉	秉
佳	佳
侍	侍
岳	岳
供	供
使	使
例	例
侠	俠
侥	僥
版	版
侄	侄
侦	偵
侣	侶
侧	側
凭	憑
侨	僑
佩	佩
货	貨
侈	侈
依	依
卑	卑
的	的
迫	迫
质	質
欣	欣
征	征
往	往
爬	爬
彼	彼
径	徑
所	所
舍	舍
金	金
刹	剎
命	命
肴	餚
斧	斧
爸	爸
采	採
觅	覓
受	受
乳	乳
贪	貪
念	念
贫	貧
忿	忿
肤	膚
肺	肺
肢	肢
肿	腫
胀	脹
朋	朋
股	股
肮	骯
肪	肪
肥	肥
服	服
胁	脅
周	周
昏	昏
鱼	魚
兔	兔
狐	狐
忽	忽
狗	狗
狞	獰
备	備
饰	飾
饱	飽
饲	飼
变	變
京	京
享	享
庞	龐
店	店
夜	夜
庙	廟
府	府
底	底
疟	瘧
疙	疙
疚	疚
剂	劑
卒	卒
郊	郊
庚	庚
废	廢
净	淨
盲	盲
放	放
刻	刻
育	育
氓	氓
闸	閘
闹	鬧
郑	鄭
券	券
卷	卷
单	單
炬	炬
炒	炒
炊	炊
炕	炕
炎	炎
炉	爐
沫	沫
浅	淺
法	法
泄	洩
沽	沽
河	河
沾	沾
泪	淚
沮	沮
油	油
泊	泊
沿	沿
泡	泡
注	注
泣	泣
泞	濘
泻	瀉
泌	泌
泳	泳
泥	泥
沸	沸
沼	沼
波	波
泼	潑
泽	澤
治	治
怔	怔
怯	怯
怖	怖
性	性
怕	怕
怜	憐
怪	怪
怡	怡
学	學
宝	寶
宗	宗
定	定
宠	寵
宜	宜
审	審
宙	宙
官	官
空	空
帘	簾
宛	宛
实	實
试	試
郎	郎
诗	詩
肩	肩
房	房
诚	誠
衬	襯
衫	衫
视	視
祈	祈
话	話
诞	誕
诡	詭
询	詢
该	該
详	詳
建	建
肃	肅
录	錄
隶	隸
帚	帚
屉	屜
居	居
届	屆
刷	刷
屈	屈
弧	弧
弥	彌
弦	弦
承	承
孟	孟
陋	陋
陌	陌
孤	孤
陕	陝
降	降
函	函
限	限
妹	妹
姑	姑
姐	姐
姓	姓
妮	妮
始	始
姆	姆
迢	迢
驾	駕
叁	叄
参	參
艰	艱
线	線
练	練
组	組
绅	紳
细	細
驶	駛
织	織
驹	駒
终	終
驻	駐
绊	絆
驼	駝
绍	紹
绎	繹
经	經
贯	貫
契	契
贰	貳
奏	奏
春	春
帮	幫
玷	玷
珍	珍
玲	玲
珊	珊
玻	玻
毒	毒
型	型
拭	拭
挂	掛
封	封
持	持
拷	拷
拱	拱
项	項
垮	垮
挎	挎
城	城
挟	挾
挠	撓
政	政
赴	赴
赵	趙
挡	擋
拽	拽
哉	哉
挺	挺
括	括
垢	垢
拴	拴
拾	拾
挑	挑
垛	垛
指	指
垫	墊
挣	掙
挤	擠
拼	拼
挖	挖
按	按
挥	揮
挪	挪
拯	拯
某	某
甚	甚
荆	荊
茸	茸
革	革
茬	茬
荐	薦
巷	巷
带	帶
草	草
茧	繭
茵	茵
茶	茶
荒	荒
茫	茫
荡	盪
荣	榮
荤	葷
荧	熒
故	故
胡	胡
荫	蔭
荔	荔
南	南
药	藥
标	標
栈	棧
柑	柑
枯	枯
柄	柄
栋	棟
相	相
查	查
柏	柏
栅	柵
柳	柳
柱	柱
柿	柿
栏	欄
柠	檸
树	樹
勃	勃
要	要
柬	柬
咸	鹹
威	威
歪	歪
研	研
砖	磚
厘	厘
厚	厚
砌	砌
砂	砂
泵	泵
砚	硯
砍	砍
面	面
耐	耐
耍	耍
牵	牽
鸥	鷗
残	殘
殃	殃
轴	軸
轻	輕
鸦	鴉
皆	皆
韭	韭
背	背
战	戰
点	點
虐	虐
临	臨
览	覽
竖	豎
省	省
削	削
尝	嘗
昧	昧
盹	盹
是	是
盼	盼
眨	眨
哇	哇
哄	哄
哑	啞
显	顯
冒	冒
映	映
星	星
昨	昨
咧	咧
昭	昭
畏	畏
趴	趴
胃	胃
贵	貴
界	界
虹	虹
虾	蝦
蚁	蟻
思	思
蚂	螞
虽	雖
品	品
咽	咽
骂	罵
勋	勳
哗	譁
咱	咱
响	響
哈	哈
哆	哆
咬	咬
咳	咳
咪	咪
哪	哪
哟	喲
炭	炭
峡	峽
罚	罰
贱	賤
贴	貼
贻	貽
骨	骨
幽	幽
钙	鈣
钝	鈍
钞	鈔
钟	鍾
钢	鋼
钠	鈉
钥	鑰
钦	欽
钧	鈞
钩	鉤
钮	鈕
卸	卸
缸	缸
拜	拜
看	看
矩	矩
毡	氈
氢	氫
怎	怎
牲	牲
选	選
适	適
秒	秒
香	香
种	種
秋	秋
科	科
重	重
复	復
竿	竿
段	段
便	便
俩	倆
贷	貸
顺	順
修	修
俏	俏
保	保
促	促
俄	俄
俐	俐
侮	侮
俭	儉
俗	俗
俘	俘
信	信
皇	皇
泉	泉
鬼	鬼
侵	侵
禹	禹
侯	侯
追	追
俊	俊
盾	盾
待	待
徊	徊
衍	衍
律	律
很	很
须	須
叙	敘
剑	劍
逃	逃
食	食
盆	盆
胚	胚
胧	朧
胆	膽
胜	勝
胞	胞
胖	胖
脉	脈
胎	胎
勉	勉
狭	狹
狮	獅
独	獨
狰	猙
狡	狡
狱	獄
狠	狠
贸	貿
怨	怨
急	急
饵	餌
饶	饒
蚀	蝕
饺	餃
饼	餅
峦	巒
弯	彎
将	將
奖	獎
哀	哀
亭	亭
亮	亮
度	度
迹	跡
庭	庭
疮	瘡
疯	瘋
疫	疫
疤	疤
咨	諮
姿	姿
亲	親
音	音
帝	帝
施	施
闺	閨
闻	聞
闽	閩
阀	閥
阁	閣
差	差
养	養
美	美
姜	姜
叛	叛
送	送
类	類
迷	迷
籽	籽
娄	婁
前	前
首	首
逆	逆
兹	茲
总	總
炼	煉
炸	炸
烁	爍
炮	炮
炫	炫
烂	爛
剃	剃
洼	窪
洁	潔
洪	洪
洒	灑
柒	柒
浇	澆
浊	濁
洞	洞
测	測
洗	洗
活	活
派	派
洽	洽
染	染
洛	洛
浏	瀏
济	濟
洋	洋
洲	洲
浑	渾
浓	濃
津	津
恃	恃
恒	恆
恢	恢
恍	恍
恬	恬
恤	恤
恰	恰
恼	惱
恨	恨
举	舉
觉	覺
宣	宣
宦	宦
室	室
宫	宮
宪	憲
突	突
穿	穿
窃	竊
客	客
诫	誡
冠	冠
诬	誣
语	語
扁	扁
袄	襖
祖	祖
神	神
祝	祝
祠	祠
误	誤
诱	誘
诲	誨
说	說
诵	誦
垦	墾
退	退
既	既
屋	屋
昼	晝
屏	屏
屎	屎
费	費
陡	陡
逊	遜
眉	眉
孩	孩
陨	隕
除	除
险	險
院	院
娃	娃
姥	姥
姨	姨
姻	姻
娇	嬌
姚	姚
娜	娜
怒	怒
架	架
贺	賀
盈	盈
勇	勇
怠	怠
癸	癸
蚤	蚤
柔	柔
垒	壘
绑	綁
绒	絨
结	結
绕	繞
骄	驕
绘	繪
给	給
绚	絢
骆	駱
络	絡
绝	絕
绞	絞
骇	駭
统	統
耕	耕
耘	耘
耗	耗
耙	耙
艳	豔
泰	泰
秦	秦
珠	珠
班	班
素	素
匿	匿
蚕	蠶
顽	頑
盏	盞
匪	匪
捞	撈
栽	栽
捕	捕
埂	埂
捂	捂
振	振
载	載
赶	趕
起	起
盐	鹽
捎	捎
捍	捍
捏	捏
埋	埋
捉	捉
捆	捆
捐	捐
损	損
袁	袁
捌	捌
都	都
哲	哲
逝	逝
捡	撿
挫	挫
换	換
挽	挽
挚	摯
热	熱
恐	恐
捣	搗
壶	壺
捅	捅
埃	埃
挨	挨
耻	恥
耿	耿
耽	耽
聂	聶
恭	恭
莽	莽
莱	萊
莲	蓮
莫	莫
莉	莉
荷	荷
获	獲
晋	晉
恶	惡
莹	瑩
莺	鶯
真	真
框	框
梆	梆
桂	桂
桔	桔
栖	棲
档	檔
桐	桐
株	株
桥	橋
桦	樺
栓	栓
桃	桃
格	格
桩	樁
校	校
核	核
样	樣
根	根
索	索
哥	哥
速	速
逗	逗
栗	栗
贾	賈
酌	酌
配	配
翅	翅
辱	辱
唇	唇
夏	夏
砸	砸
砰	砰
砾	礫
础	礎
破	破
原	原
套	套
逐	逐
烈	烈
殊	殊
殉	殉
顾	顧
轿	轎
较	較
顿	頓
毙	斃
致	致
柴	柴
桌	桌
虑	慮
监	監
紧	緊
党	黨
逞	逞
晒	曬
眠	眠
晓	曉
哮	哮
唠	嘮
鸭	鴨
晃	晃
哺	哺
晌	晌
剔	剔
晕	暈
蚌	蚌
畔	畔
蚣	蚣
蚊	蚊
蚪	蚪
蚓	蚓
哨	哨
哩	哩
圃	圃
哭	哭
哦	哦
恩	恩
鸯	鴦
唤	喚
唁	唁
哼	哼
唧	唧
啊	啊
唉	唉
唆	唆
罢	罷
峭	峭
峨	峨
峰	峰
圆	圓
峻	峻
贼	賊
贿	賄
赂	賂
赃	贓
钱	錢
钳	鉗
钻	鑽
钾	鉀
铁	鐵
铃	鈴
铅	鉛
缺	缺
氧	氧
氨	氨
特	特
牺	犧
造	造
乘	乘
敌	敵
秤	秤
租	租
积	積
秧	秧
秩	秩
称	稱
秘	秘
透	透
笔	筆
笑	笑
笋	筍
债	債
借	借
值	值
倚	倚
俺	俺
倾	傾
倒	倒
倘	倘
俱	俱
倡	倡
候	候
赁	賃
俯	俯
倍	倍
倦	倦
健	健
臭	臭
射	射
躬	躬
息	息
倔	倔
徒	徒
徐	徐
殷	殷
舰	艦
舱	艙
般	般
航	航
途	途
拿	拿
耸	聳
爹	爹
舀	舀
爱	愛
豺	豺
豹	豹
颁	頒
颂	頌
翁	翁
胰	胰
脆	脆
脂	脂
胸	胸
胳	胳
脏	髒
脐	臍
胶	膠
脑	腦
脓	膿
逛	逛
狸	狸
狼	狼
卿	卿
逢	逢
鸵	鴕
留	留
鸳	鴛
皱	皺
饿	餓
馁	餒
凌	凌
凄	淒
恋	戀
桨	槳
浆	漿
衰	衰
衷	衷
高	高
郭	郭
席	席
准	准
座	座
症	症
病	病
疾	疾
斋	齋
疹	疹
疼	疼
疲	疲
脊	脊
效	效
离	離
紊	紊
唐	唐
瓷	瓷
资	資
凉	涼
站	站
剖	剖
竞	競
部	部
旁	旁
旅	旅
畜	畜
阅	閱
羞	羞
羔	羔
瓶	瓶
拳	拳
粉	粉
料	料
益	益
兼	兼
烤	烤
烘	烘
烦	煩
烧	燒
烛	燭
烟	煙
烙	烙
递	遞
涛	濤
浙	浙
涝	澇
浦	浦
酒	酒
涉	涉
消	消
涡	渦
浩	浩
海	海
涂	塗
浴	浴
浮	浮
涣	渙
涤	滌
流	流
润	潤
涧	澗
涕	涕
浪	浪
浸	浸
涨	漲
烫	燙
涩	澀
涌	湧
悖	悖
悟	悟
悄	悄
悍	悍
悔	悔
悯	憫
悦	悅
害	害
宽	寬
家	家
宵	宵
宴	宴
宾	賓
窍	竅
窄	窄
容	容
宰	宰
案	案
请	請
朗	朗
诸	諸
诺	諾
读	讀
扇	扇
诽	誹
袜	襪
袖	袖
袍	袍
被	被
祥	祥
课	課
冥	冥
谁	誰
调	調
冤	冤
谅	諒
谆	諄
谈	談
谊	誼
剥	剝
恳	懇
展	展
剧	劇
屑	屑
弱	弱
陵	陵
祟	祟
陶	陶
陷	陷
陪	陪
娱	娛
娟	娟
恕	恕
娥	娥
娘	娘
通	通
能	能
难	難
预	預
桑	桑
绢	絹
绣	繡
验	驗
继	繼
骏	駿
球	球
琐	瑣
理	理
琉	琉
琅	琅
捧	捧
堵	堵
措	措
描	描
域	域
捺	捺
掩	掩
捷	捷
排	排
焉	焉
掉	掉
捶	捶
赦	赦
堆	堆
推	推
埠	埠
掀	掀
授	授
捻	捻
教	教
掏	掏
掐	掐
掠	掠
掂	掂
培	培
接	接
掷	擲
控	控
探	探
据	據
掘	掘
掺	摻
职	職
基	基
聆	聆
勘	勘
聊	聊
娶	娶
著	著
菱	菱
勒	勒
黄	黃
菲	菲
萌	萌
萝	蘿
菌	菌
萎	萎
菜	菜
萄	萄
菊	菊
菩	菩
萍	萍
菠	菠
萤	螢
营	營
乾	乾
萧	蕭
萨	薩
菇	菇
械	械
彬	彬
梦	夢
婪	婪
梗	梗
梧	梧
梢	梢
梅	梅
检	檢
梳	梳
梯	梯
桶	桶
梭	梭
救	救
曹	曹
副	副
票	票
酝	醞
酗	酗
厢	廂
戚	戚
硅	硅
硕	碩
奢	奢
盔	盔
爽	爽
聋	聾
袭	襲
盛	盛
匾	匾
雪	雪
辅	輔
辆	輛
颅	顱
虚	虛
彪	彪
雀	雀
堂	堂
常	常
眶	眶
匙	匙
晨	晨
睁	睜
眯	眯
眼	眼
悬	懸
野	野
啪	啪
啦	啦
曼	曼
晦	晦
晚	晚
啄	啄
啡	啡
距	距
趾	趾
啃	啃
跃	躍
略	略
蚯	蚯
蛀	蛀
蛇	蛇
唬	唬
累	累
鄂	鄂
唱	唱
患	患
啰	囉
唾	唾
唯	唯
啤	啤
啥	啥
啸	嘯
崖	崖
崎	崎
崭	嶄
逻	邏
崔	崔
帷	帷
崩	崩
崇	崇
崛	崛
婴	嬰
圈	圈
铐	銬
铛	鐺
铝	鋁
铜	銅
铭	銘
铲	鏟
银	銀
矫	矯
甜	甜
秸	秸
梨	梨
犁	犁
秽	穢
移	移
笨	笨
笼	籠
笛	笛
笙	笙
符	符
第	第
敏	敏
做	做
袋	袋
悠	悠
偿	償
偶	偶
偎	偎
偷	偷
您	您
售	售
停	停
偏	偏
躯	軀
兜	兜
假	假
衅	釁
徘	徘
徙	徙
得	得
衔	銜
盘	盤
舶	舶
船	船
舵	舵
斜	斜
盒	盒
鸽	鴿
敛	斂
悉	悉
欲	欲
彩	彩
领	領
脚	腳
脖	脖
脯	脯
豚	豚
脸	臉
脱	脫
象	象
够	夠
逸	逸
猜	猜
猪	豬
猎	獵
猫	貓
凰	凰
猖	猖
猛	猛
祭	祭
馅	餡
馆	館
凑	湊
减	減
毫	毫
烹	烹
庶	庶
麻	麻
庵	庵
痊	痊
痒	癢
痕	痕
廊	廊
康	康
庸	庸
鹿	鹿
盗	盜
章	章
竟	竟
商	商
族	族
旋	旋
望	望
率	率
阎	閻
阐	闡
着	著
羚	羚
盖	蓋
眷	眷
粘	粘
粗	粗
粒	粒
断	斷
剪	剪
兽	獸
焊	焊
焕	煥
清	清
添	添
鸿	鴻
淋	淋
涯	涯
淹	淹
渠	渠
渐	漸
淑	淑
淌	淌
混	混
淮	淮
淆	淆
渊	淵
淫	淫
渔	漁
淘	淘
淳	淳
液	液
淤	淤
淡	淡
淀	澱
深	深
涮	涮
涵	涵
婆	婆
梁	梁
渗	滲
情	情
惜	惜
惭	慚
悼	悼
惧	懼
惕	惕
惟	惟
惊	驚
惦	惦
悴	悴
惋	惋
惨	慘
惯	慣
寇	寇
寅	寅
寄	寄
寂	寂
宿	宿
窒	窒
窑	窯
密	密
谋	謀
谍	諜
谎	謊
谐	諧
袱	袱
祷	禱
祸	禍
谓	謂
谚	諺
谜	謎
逮	逮
敢	敢
尉	尉
屠	屠
弹	彈
隋	隋
堕	墮
随	隨
蛋	蛋
隅	隅
隆	隆
隐	隱
婚	婚
婶	嬸
婉	婉
颇	頗
颈	頸
绩	績
绪	緒
续	續
骑	騎
绰	綽
绳	繩
维	維
绵	綿
绷	繃
绸	綢
综	綜
绽	綻
绿	綠
缀	綴
巢	巢
琴	琴
琳	琳
琢	琢
琼	瓊
斑	斑
替	替
揍	揍
款	款
堪	堪
塔	塔
搭	搭
堰	堰
揩	揩
越	越
趁	趁
趋	趨
超	超
揽	攬
堤	堤
提	提
博	博
揭	揭
喜	喜
彭	彭
揣	揣
插	插
揪	揪
搜	搜
煮	煮
援	援
搀	攙
裁	裁
搁	擱
搓	搓
搂	摟
搅	攪
壹	壹
握	握
搔	搔
揉	揉
斯	斯
期	期
欺	欺
联	聯
葫	葫
散	散
惹	惹
葬	葬
募	募
葛	葛
董	董
葡	葡
敬	敬
葱	蔥
蒋	蔣
蒂	蒂
落	落
韩	韓
朝	朝
辜	辜
葵	葵
棒	棒
棱	棱
棋	棋
椰	椰
植	植
森	森
焚	焚
椅	椅
椒	椒
棵	棵
棍	棍
椎	椎
棉	棉
棚	棚
棕	棕
棺	棺
榔	榔
椭	橢
惠	惠
惑	惑
逼	逼
粟	粟
棘	棘
酣	酣
酥	酥
厨	廚
厦	廈
硬	硬
硝	硝
确	確
硫	硫
雁	雁
殖	殖
裂	裂
雄	雄
颊	頰
雳	靂
暂	暫
雅	雅
翘	翹
辈	輩
悲	悲
紫	紫
凿	鑿
辉	輝
敞	敞
棠	棠
赏	賞
掌	掌
晴	晴
睐	睞
暑	暑
最	最
晰	晰
量	量
鼎	鼎
喷	噴
喳	喳
晶	晶
喇	喇
遇	遇
喊	喊
遏	遏
晾	晾
景	景
畴	疇
践	踐
跋	跋
跌	跌
跑	跑
跛	跛
遗	遺
蛙	蛙
蛛	蛛
蜓	蜓
蜒	蜒
蛤	蛤
喝	喝
鹃	鵑
喂	喂
喘	喘
喉	喉
喻	喻
啼	啼
喧	喧
嵌	嵌
幅	幅
帽	帽
赋	賦
赌	賭
赎	贖
赐	賜
赔	賠
黑	黑
铸	鑄
铺	鋪
链	鏈
销	銷
锁	鎖
锄	鋤
锅	鍋
锈	鏽
锋	鋒
锌	鋅
锐	銳
甥	甥
掰	掰
短	短
智	智
氮	氮
毯	毯
氯	氯
鹅	鵝
剩	剩
稍	稍
程	程
稀	稀
税	稅
筐	筐
等	等
筑	築
策	策
筛	篩
筒	筒
筏	筏
答	答
筋	筋
筝	箏
傲	傲
傅	傅
牌	牌
堡	堡
集	集
焦	焦
傍	傍
储	儲
皓	皓
皖	皖
粤	粵
奥	奧
街	街
惩	懲
御	御
循	循
艇	艇
舒	舒
逾	逾
番	番
释	釋
禽	禽
腊	臘
脾	脾
腋	腋
腔	腔
腕	腕
鲁	魯
猩	猩
猬	蝟
猾	猾
猴	猴
惫	憊
然	然
馈	饋
馋	饞
装	裝
蛮	蠻
就	就
敦	敦
斌	斌
痘	痘
痢	痢
痪	瘓
痛	痛
童	童
竣	竣
阔	闊
善	善
翔	翔
羡	羨
普	普
粪	糞
尊	尊
奠	奠
道	道
遂	遂
曾	曾
焰	焰
港	港
滞	滯
湖	湖
湘	湘
渣	渣
渤	渤
渺	渺
湿	濕
温	溫
渴	渴
溃	潰
溅	濺
滑	滑
湃	湃
渝	渝
湾	灣
渡	渡
游	游
滋	滋
渲	渲
溉	溉
愤	憤
慌	慌
惰	惰
愕	愕
愣	愣
惶	惶
愧	愧
愉	愉
慨	慨
割	割
寒	寒
富	富
寓	寓
窜	竄
窝	窩
窖	窖
窗	窗
窘	窘
遍	遍
雇	雇
裕	裕
裤	褲
裙	裙
禅	禪
禄	祿
谢	謝
谣	謠
谤	謗
谦	謙
犀	犀
属	屬
屡	屢
强	強
粥	粥
疏	疏
隔	隔
隙	隙
隘	隘
媒	媒
絮	絮
嫂	嫂
媚	媚
婿	婿
登	登
缅	緬
缆	纜
缉	緝
缎	緞
缓	緩
缔	締
缕	縷
骗	騙
编	編
骚	騷
缘	緣
瑟	瑟
鹉	鵡
瑞	瑞
瑰	瑰
瑙	瑙
魂	魂
肆	肆
摄	攝
摸	摸
填	填
搏	搏
塌	塌
鼓	鼓
摆	擺
携	攜
搬	搬
摇	搖
搞	搞
塘	塘
摊	攤
聘	聘
斟	斟
蒜	蒜
勤	勤
靴	靴
靶	靶
鹊	鵲
蓝	藍
墓	墓
幕	幕
蓬	蓬
蓄	蓄
蒲	蒲
蓉	蓉
蒙	蒙
蒸	蒸
献	獻
椿	椿
禁	禁
楚	楚
楷	楷
榄	欖
想	想
槐	槐
榆	榆
楼	樓
概	概
赖	賴
酪	酪
酬	酬
感	感
碍	礙
碘	碘
碑	碑
碎	碎
碰	碰
碗	碗
碌	碌
尴	尷
雷	雷
零	零
雾	霧
雹	雹
辐	輻
辑	輯
输	輸
督	督
频	頻
龄	齡
鉴	鑒
睛	睛
睹	睹
睦	睦
瞄	瞄
睫	睫
睡	睡
睬	睬
嗜	嗜
鄙	鄙
嗦	嗦
愚	愚
暖	暖
盟	盟
歇	歇
暗	暗
暇	暇
照	照
畸	畸
跨	跨
跷	蹺
跳	跳
跺	跺
跪	跪
路	路
跤	跤
跟	跟
遣	遣
蜈	蜈
蜗	蝸
蛾	蛾
蜂	蜂
蜕	蛻
嗅	嗅
嗡	嗡
嗓	嗓
署	署
置	置
罪	罪
罩	罩
蜀	蜀
幌	幌
错	錯
锚	錨
锡	錫
锣	鑼
锤	錘
锥	錐
锦	錦
键	鍵
锯	鋸
锰	錳
矮	矮
辞	辭
稚	稚
稠	稠
颓	頹
愁	愁
筹	籌
签	簽
简	簡
筷	筷
毁	毀
舅	舅
鼠	鼠
催	催
傻	傻
像	像
躲	躲
魁	魁
衙	衙
微	微
愈	愈
遥	遙
腻	膩
腰	腰
腥	腥
腮	腮
腹	腹
腺	腺
鹏	鵬
腾	騰
腿	腿
鲍	鮑
猿	猿
颖	穎
触	觸
解	解
煞	煞
雏	雛
馍	饃
馏	餾
酱	醬
禀	稟
痹	痺
廓	廓
痴	痴
痰	痰
廉	廉
靖	靖
新	新
韵	韻
意	意
誊	謄
粮	糧
数	數
煎	煎
塑	塑
慈	慈
煤	煤
煌	煌
满	滿
漠	漠
滇	滇
源	源
滤	濾
滥	濫
滔	滔
溪	溪
溜	溜
漓	漓
滚	滾
溢	溢
溯	溯
滨	濱
溶	溶
溺	溺
粱	粱
滩	灘
慎	慎
誉	譽
塞	塞
寞	寞
窥	窺
窟	窟
寝	寢
谨	謹
褂	褂
裸	裸
福	福
谬	謬
群	群
殿	殿
辟	辟
障	障
媳	媳
嫉	嫉
嫌	嫌
嫁	嫁
叠	疊
缚	縛
缝	縫
缠	纏
缤	繽
剿	剿
静	靜
碧	碧
璃	璃
赘	贅
熬	熬
墙	牆
墟	墟
嘉	嘉
摧	摧
赫	赫
截	截
誓	誓
境	境
摘	摘
摔	摔
撇	撇
聚	聚
慕	慕
暮	暮
摹	摹
蔓	蔓
蔑	蔑
蔡	蔡
蔗	蔗
蔽	蔽
蔼	藹
熙	熙
蔚	蔚
兢	兢
模	模
槛	檻
榴	榴
榜	榜
榨	榨
榕	榕
歌	歌
遭	遭
酵	酵
酷	酷
酿	釀
酸	酸
碟	碟
碱	鹼
碳	碳
磁	磁
愿	願
需	需
辖	轄
辗	輾
雌	雌
裳	裳
颗	顆
瞅	瞅
墅	墅
嗽	嗽
踊	踴
蜻	蜻
蜡	蠟
蝇	蠅
蜘	蜘
蝉	蟬
嘛	嘛
嘀	嘀
赚	賺
锹	鍬
锻	鍛
镀	鍍
舞	舞
舔	舔
稳	穩
熏	熏
箕	箕
算	算
箩	籮
管	管
箫	簫
舆	輿
僚	僚
僧	僧
鼻	鼻
魄	魄
魅	魅
貌	貌
膜	膜
膊	膊
膀	膀
鲜	鮮
疑	疑
孵	孵
馒	饅
裹	裹
敲	敲
豪	豪
膏	膏
遮	遮
腐	腐
瘩	瘩
瘟	瘟
瘦	瘦
辣	辣
彰	彰
竭	竭
端	端
旗	旗
精	精
粹	粹
歉	歉
弊	弊
熄	熄
熔	熔
煽	煽
潇	瀟
漆	漆
漱	漱
漂	漂
漫	漫
滴	滴
漾	漾
演	演
漏	漏
慢	慢
慷	慷
寨	寨
赛	賽
寡	寡
察	察
蜜	蜜
寥	寥
谭	譚
肇	肇
褐	褐
褪	褪
谱	譜
隧	隧
嫩	嫩
翠	翠
熊	熊
凳	凳
骡	騾
缩	縮
慧	慧
撵	攆
撕	撕
撒	撒
撩	撩
趣	趣
趟	趟
撑	撐
撮	撮
撬	撬
播	播
擒	擒
墩	墩
撞	撞
撤	撤
增	增
撰	撰
聪	聰
鞋	鞋
鞍	鞍
蕉	蕉
蕊	蕊
蔬	蔬
蕴	蘊
横	橫
槽	槽
樱	櫻
橡	橡
樟	樟
橄	橄
敷	敷
豌	豌
飘	飄
醋	醋
醇	醇
醉	醉
磕	磕
磊	磊
磅	磅
碾	碾
震	震
霄	霄
霉	霉
瞒	瞞
题	題
暴	暴
瞎	瞎
嘻	嘻
嘶	嘶
嘲	嘲
嘹	嘹
影	影
踢	踢
踏	踏
踩	踩
踪	蹤
蝶	蝶
蝴	蝴
蝠	蝠
蝎	蠍
蝌	蝌
蝗	蝗
蝙	蝙
嘿	嘿
嘱	囑
幢	幢
墨	墨
镇	鎮
镐	鎬
镑	鎊
靠	靠
稽	稽
稻	稻
黎	黎
稿	稿
稼	稼
箱	箱
篓	簍
箭	箭
篇	篇
僵	僵
躺	躺
僻	僻
德	德
艘	艘
膝	膝
膛	膛
鲤	鯉
鲫	鯽
熟	熟
摩	摩
褒	褒
瘪	癟
瘤	瘤
瘫	癱
凛	凜
颜	顏
毅	毅
糊	糊
遵	遵
憋	憋
潜	潛
澎	澎
潮	潮
潭	潭
鲨	鯊
澳	澳
潘	潘
澈	澈
澜	瀾
澄	澄
懂	懂
憔	憔
懊	懊
憎	憎
额	額
翩	翩
褥	褥
谴	譴
鹤	鶴
憨	憨
慰	慰
劈	劈
履	履
豫	豫
缭	繚
撼	撼
擂	擂
操	操
擅	擅
燕	燕
蕾	蕾
薯	薯
薛	薛
薇	薇
擎	擎
薪	薪
薄	薄
颠	顛
翰	翰
噩	噩
橱	櫥
橙	橙
橘	橘
整	整
融	融
瓢	瓢
醒	醒
霍	霍
霎	霎
辙	轍
冀	冀
餐	餐
嘴	嘴
踱	踱
蹄	蹄
蹂	蹂
蟆	蟆
螃	螃
器	器
噪	噪
鹦	鸚
赠	贈
默	默
黔	黔
镜	鏡
赞	贊
穆	穆
篮	籃
篡	篡
篷	篷
篱	籬
儒	儒
邀	邀
衡	衡
膨	膨
雕	雕
鲸	鯨
磨	磨
瘾	癮
瘸	瘸
凝	凝
辨	辨
辩	辯
糙	糙
糖	糖
糕	糕
燃	燃
濒	瀕
澡	澡
激	激
懒	懶
憾	憾
懈	懈
窿	窿
壁	壁
避	避
缰	韁
缴	繳
戴	戴
擦	擦
藉	藉
鞠	鞠
藏	藏
藐	藐
檬	檬
檐	檐
檀	檀
礁	礁
磷	磷
霜	霜
霞	霞
瞭	瞭
瞧	瞧
瞬	瞬
瞳	瞳
瞩	矚
瞪	瞪
曙	曙
蹋	蹋
蹈	蹈
螺	螺
蟋	蟋
蟀	蟀
嚎	嚎
赡	贍
穗	穗
魏	魏
簧	簧
簇	簇
繁	繁
徽	徽
爵	爵
朦	朦
臊	臊
鳄	鱷
癌	癌
辫	辮
赢	贏
糟	糟
糠	糠
燥	燥
懦	懦
豁	豁
臀	臀
臂	臂
翼	翼
骤	驟
藕	藕
鞭	鞭
藤	藤
覆	覆
瞻	瞻
蹦	蹦
嚣	囂
镰	鐮
翻	翻
鳍	鰭
鹰	鷹
瀑	瀑
襟	襟
璧	璧
戳	戳
孽	孽
警	警
蘑	蘑
藻	藻
攀	攀
曝	曝
蹲	蹲
蹭	蹭
蹬	蹬
巅	巔
簸	簸
簿	簿
蟹	蟹
颤	顫
靡	靡
癣	癬
瓣	瓣
羹	羹
鳖	鱉
爆	爆
疆	疆
鬓	鬢
壤	壤
馨	馨
耀	耀
躁	躁
蠕	蠕
嚼	嚼
嚷	嚷
巍	巍
籍	籍
鳞	鱗
魔	魔
糯	糯
灌	灌
譬	譬
蠢	蠢
霸	霸
露	露
霹	霹
躏	躪
黯	黯
髓	髓
赣	贛
囊	囊
镶	鑲
瓤	瓤
罐	罐
矗	矗
乂	乂
乜	乜
兀	兀
弋	弋
孑	孑
孓	孓
幺	么
亓	亓
韦	韋
廿	廿
丏	丏
卅	卅
仄	仄
厄	厄
仃	仃
仉	仉
仂	仂
兮	兮
刈	刈
爻	爻
卞	卞
闩	閂
讣	訃
尹	尹
夬	夬
爿	爿
毋	毋
邗	邗
邛	邛
艽	艽
艿	艿
札	札
叵	叵
匝	匝
丕	丕
匜	匜
劢	勱
卟	卟
叱	叱
叻	叻
仨	仨
仕	仕
仟	仟
仡	仡
仫	仫
仞	仞
卮	卮
氐	氐
犰	犰
刍	芻
邝	鄺
邙	邙
汀	汀
讦	訐
讧	訌
讪	訕
讫	訖
尻	尻
阡	阡
尕	尕
弁	弁
驭	馭
匡	匡
耒	耒
玎	玎
玑	璣
邢	邢
圩	圩
圬	圬
圭	圭
扦	扦
圪	圪
圳	圳
圹	壙
扪	捫
圮	圮
圯	圯
芊	芊
芍	芍
芄	芄
芨	芨
芑	芑
芎	芎
芗	薌
亘	亙
厍	厙
夼	夼
戍	戍
尥	尥
乩	乩
旯	旯
曳	曳
岌	岌
屺	屺
凼	凼
囡	囡
钇	釔
缶	缶
氘	氘
氖	氖
牝	牝
伎	伎
伛	傴
伢	伢
佤	佤
仵	仵
伥	倀
伧	傖
伉	伉
伫	佇
囟	囟
汆	汆
刖	刖
夙	夙
旮	旮
刎	刎
犷	獷
犸	獁
舛	舛
凫	鳧
邬	鄔
饧	餳
汕	汕
汔	汔
汐	汐
汲	汲
汜	汜
汊	汊
忖	忖
忏	懺
讴	謳
讵	詎
祁	祁
讷	訥
聿	聿
艮	艮
厾	厾
阱	阱
阮	阮
阪	阪
丞	丞
妁	妁
牟	牟
纡	紆
纣	紂
纥	紇
纨	紈
玕	玕
玙	璵
抟	摶
抔	抔
圻	圻
坂	坂
坍	坍
坞	塢
抃	抃
抉	抉
㧐	㩳
芫	芫
邯	邯
芸	芸
芾	芾
苈	藶
苣	苣
芷	芷
芮	芮
苋	莧
芼	芼
苌	萇
苁	蓯
芩	芩
芪	芪
芡	芡
芟	芟
苄	苄
苎	苧
苡	苡
杌	杌
杓	杓
杞	杞
杈	杈
忑	忑
孛	孛
邴	邴
邳	邳
矶	磯
奁	奩
豕	豕
忒	忒
欤	歟
轫	軔
迓	迓
邶	邶
忐	忐
卣	卣
邺	鄴
旰	旰
呋	呋
呒	嘸
呓	囈
呔	呔
呖	嚦
呃	呃
旸	暘
吡	吡
町	町
虬	虯
呗	唄
吽	吽
吣	唚
吲	吲
帏	幃
岐	岐
岈	岈
岘	峴
岑	岑
岚	嵐
兕	兕
囵	圇
囫	囫
钊	釗
钋	釙
钌	釕
迕	迕
氙	氙
氚	氚
牤	牤
佞	佞
邱	邱
攸	攸
佚	佚
佝	佝
佟	佟
佗	佗
伽	伽
彷	彷
佘	佘
佥	僉
孚	孚
豸	豸
坌	坌
肟	肟
邸	邸
奂	奐
劬	劬
狄	狄
狁	狁
鸠	鳩
邹	鄒
饨	飩
饩	餼
饪	飪
饫	飫
饬	飭
亨	亨
庑	廡
庋	庋
疔	疔
疖	癤
肓	肓
闱	闈
闳	閎
闵	閔
羌	羌
炀	煬
沣	灃
沅	沅
沔	沔
沤	漚
沌	沌
沏	沏
沚	沚
汩	汩
汨	汨
沂	沂
汾	汾
沨	渢
汴	汴
汶	汶
沆	沆
沩	溈
泐	泐
怃	憮
怄	慪
忡	忡
忤	忤
忾	愾
怅	悵
忻	忻
忪	忪
怆	愴
忭	忭
忸	忸
诂	詁
诃	訶
诅	詛
诋	詆
诌	謅
诏	詔
诒	詒
孜	孜
陇	隴
陀	陀
陂	陂
陉	陘
妍	妍
妩	嫵
妪	嫗
妣	妣
妊	妊
妗	妗
妫	媯
妞	妞
姒	姒
妤	妤
邵	邵
劭	劭
刭	剄
甬	甬
邰	邰
纭	紜
纰	紕
纴	紝
纶	綸
纾	紓
玮	瑋
玡	玡
玭	玭
玠	玠
玢	玢
玥	玥
玦	玦
盂	盂
忝	忝
匦	匭
坩	坩
抨	抨
拤	拤
坫	坫
拈	拈
垆	壚
抻	抻
劼	劼
拃	拃
拊	拊
坼	坼
坻	坻
㧟	擓
坨	坨
坭	坭
抿	抿
坳	坳
耶	耶
苷	苷
苯	苯
苤	苤
茏	蘢
苫	苫
苜	苜
苴	苴
苒	苒
苘	苘
茌	茌
苻	苻
苓	苓
茚	茚
茆	茆
茑	蔦
茓	茓
茔	塋
茕	煢
茀	茀
苕	苕
枥	櫪
枇	枇
杪	杪
杳	杳
枧	梘
杵	杵
枨	棖
枞	樅
枋	枋
杻	杻
杷	杷
杼	杼
矸	矸
砀	碭
刳	刳
奄	奄
瓯	甌
殁	歿
郏	郟
轭	軛
郅	郅
鸢	鳶
盱	盱
昊	昊
昙	曇
杲	杲
昃	昃
咂	咂
呸	呸
昕	昕
昀	昀
旻	旻
昉	昉
炅	炅
咔	咔
畀	畀
虮	蟣
咀	咀
呷	呷
黾	黽
呱	呱
呤	呤
咚	咚
咆	咆
咛	嚀
呶	呶
呣	呣
呦	呦
咝	噝
岢	岢
岿	巋
岬	岬
岫	岫
帙	帙
岣	岣
峁	峁
刿	劌
迥	迥
岷	岷
剀	剴
帔	帔
峄	嶧
沓	沓
囹	囹
罔	罔
钍	釷
钎	釺
钏	釧
钒	釩
钕	釹
钗	釵
邾	邾
迮	迮
牦	犛
竺	竺
迤	迤
佶	佶
佬	佬
佰	佰
侑	侑
侉	侉
臾	臾
岱	岱
侗	侗
侃	侃
侏	侏
侩	儈
佻	佻
佾	佾
侪	儕
佼	佼
佯	佯
侬	儂
帛	帛
阜	阜
侔	侔
徂	徂
刽	劊
郄	郄
怂	慫
籴	糴
瓮	甕
戗	戧
肼	肼
䏝	膞
肽	肽
肱	肱
肫	肫
剁	剁
迩	邇
郇	郇
狙	狙
狎	狎
狍	狍
狒	狒
咎	咎
炙	炙
枭	梟
饯	餞
饴	飴
冽	冽
冼	冼
庖	庖
疠	癘
疝	疝
疡	瘍
兖	兗
妾	妾
劾	劾
炜	煒
𬉼	𬉼
炖	燉
炘	炘
炝	熗
炔	炔
泔	泔
沭	沭
泷	瀧
泸	瀘
泱	泱
泅	泅
泗	泗
泠	泠
泺	濼
泖	泖
泫	泫
泮	泮
沱	沱
泯	泯
泓	泓
泾	涇
怙	怙
怵	怵
怦	怦
怛	怛
怏	怏
怍	怍
㤘	㥮
怩	怩
怫	怫
怿	懌
宕	宕
穹	穹
宓	宓
诓	誆
诔	誄
诖	詿
诘	詰
戾	戾
诙	詼
戽	戽
郓	鄆
衩	衩
祆	祆
祎	禕
祉	祉
祇	祇
诛	誅
诜	詵
诟	詬
诠	詮
诣	詣
诤	諍
诧	詫
诨	諢
诩	詡
戕	戕
孢	孢
亟	亟
陔	陔
妲	妲
妯	妯
姗	姍
帑	帑
弩	弩
孥	孥
驽	駑
虱	蝨
迦	迦
迨	迨
绀	紺
绁	紲
绂	紱
驷	駟
驸	駙
绉	縐
绌	絀
驿	驛
骀	駘
甾	甾
珏	珏
珐	琺
珂	珂
珑	瓏
玳	玳
珀	珀
顸	頇
珉	珉
珈	珈
拮	拮
垭	埡
挝	撾
垣	垣
挞	撻
垤	垤
赳	赳
贲	賁
垱	壋
垌	垌
郝	郝
垧	垧
垓	垓
挦	撏
垠	垠
茜	茜
荚	莢
荑	荑
贳	貰
荜	蓽
莒	莒
茼	茼
茴	茴
茱	茱
莛	莛
荞	蕎
茯	茯
荏	荏
荇	荇
荃	荃
荟	薈
荀	荀
茗	茗
荠	薺
茭	茭
茨	茨
垩	堊
荥	滎
荦	犖
荨	蕁
荩	藎
剋	剋
荪	蓀
茹	茹
荬	蕒
荮	葤
柰	柰
栉	櫛
柯	柯
柘	柘
栊	櫳
柩	柩
枰	枰
栌	櫨
柙	柙
枵	枵
柚	柚
枳	枳
柞	柞
柝	柝
栀	梔
柢	柢
栎	櫟
枸	枸
柈	柈
柁	柁
枷	枷
柽	檉
剌	剌
酊	酊
郦	酈
甭	甭
砗	硨
砘	砘
砒	砒
斫	斫
砭	砭
砜	碸
奎	奎
耷	耷
虺	虺
殂	殂
殇	殤
殄	殄
殆	殆
轱	軲
轲	軻
轳	轤
轶	軼
轸	軫
虿	蠆
毖	毖
觇	覘
尜	尜
哐	哐
眄	眄
眍	瞘
𠳐	𠳐
郢	郢
眇	眇
眊	眊
眈	眈
禺	禺
哂	哂
咴	咴
曷	曷
昴	昴
昱	昱
昵	暱
咦	咦
哓	嘵
哔	嗶
畎	畎
毗	毗
呲	呲
胄	胄
畋	畋
畈	畈
虼	虼
虻	虻
盅	盅
咣	咣
哕	噦
剐	剮
郧	鄖
咻	咻
囿	囿
咿	咿
哌	哌
哙	噲
哚	哚
咯	咯
咩	咩
咤	吒
哝	噥
哏	哏
哞	哞
峙	峙
峣	嶢
罘	罘
帧	幀
峒	峒
峤	嶠
峋	峋
峥	崢
贶	貺
钚	鈈
钛	鈦
钡	鋇
钣	鈑
钤	鈐
钨	鎢
钫	鈁
钯	鈀
氡	氡
氟	氟
牯	牯
郜	郜
秕	秕
秭	秭
竽	竽
笈	笈
笃	篤
俦	儔
俨	儼
俅	俅
俪	儷
叟	叟
垡	垡
牮	牮
俣	俁
俚	俚
皈	皈
俑	俑
俟	俟
逅	逅
徇	徇
徉	徉
舢	舢
俞	俞
郗	郗
俎	俎
郤	郤
爰	爰
郛	郛
瓴	瓴
胨	腖
胪	臚
胛	胛
胂	胂
胙	胙
胍	胍
胗	胗
胝	胝
朐	朐
胫	脛
鸨	鴇
匍	匍
狨	狨
狯	獪
飑	颮
狩	狩
狲	猻
訇	訇
逄	逄
昝	昝
饷	餉
饸	餄
饹	餎
胤	胤
孪	孿
娈	孌
弈	弈
奕	奕
庥	庥
疬	癧
疣	疣
疥	疥
疭	瘲
庠	庠
竑	竑
彦	彥
飒	颯
闼	闥
闾	閭
闿	闓
阂	閡
羑	羑
迸	迸
籼	秈
酋	酋
炳	炳
炻	炻
炽	熾
炯	炯
烀	烀
炷	炷
烃	烴
洱	洱
洹	洹
洧	洧
洌	洌
浃	浹
洇	洇
洄	洄
洙	洙
涎	涎
洎	洎
洫	洫
浍	澮
洮	洮
洵	洵
浒	滸
浔	潯
浕	濜
洳	洳
恸	慟
恓	恓
恹	懨
恫	恫
恺	愷
恻	惻
恂	恂
恪	恪
恽	惲
宥	宥
扃	扃
衲	衲
衽	衽
衿	衿
袂	袂
祛	祛
祜	祜
祓	祓
祚	祚
诮	誚
祗	祗
祢	禰
诰	誥
诳	誑
鸩	鴆
昶	昶
郡	郡
咫	咫
弭	弭
牁	牁
胥	胥
陛	陛
陟	陟
娅	婭
姮	姮
娆	嬈
姝	姝
姣	姣
姘	姘
姹	奼
怼	懟
羿	羿
炱	炱
矜	矜
绔	絝
骁	驍
骅	驊
绗	絎
绛	絳
骈	駢
耖	耖
挈	挈
珥	珥
珙	珙
顼	頊
珰	璫
珩	珩
珧	珧
珣	珣
珞	珞
琤	琤
珲	琿
敖	敖
恚	恚
埔	埔
埕	埕
埘	塒
埙	塤
埚	堝
挹	挹
耆	耆
耄	耄
埒	埒
捋	捋
贽	贄
垸	垸
捃	捃
盍	盍
荸	荸
莆	莆
莳	蒔
莴	萵
莪	莪
莠	莠
莓	莓
莜	莜
莅	蒞
荼	荼
莩	莩
荽	荽
莸	蕕
荻	荻
莘	莘
莎	莎
莞	莞
莨	莨
鸪	鴣
莼	蓴
栲	栲
栳	栳
郴	郴
桓	桓
桡	橈
桎	桎
桢	楨
桤	榿
梃	梃
栝	栝
桕	桕
桁	桁
桧	檜
桅	桅
栟	栟
桉	桉
栩	栩
逑	逑
逋	逋
彧	彧
鬲	鬲
豇	豇
酐	酐
逦	邐
厝	厝
孬	孬
砝	砝
砹	砹
砺	礪
砧	砧
砷	砷
砟	砟
砼	砼
砥	砥
砣	砣
剞	剞
砻	礱
轼	軾
轾	輊
辂	輅
鸫	鶇
趸	躉
龀	齔
鸬	鸕
虔	虔
逍	逍
眬	矓
唛	嘜
晟	晟
眩	眩
眙	眙
哧	哧
哽	哽
唔	唔
晁	晁
晏	晏
鸮	鴞
趵	趵
趿	趿
畛	畛
蚨	蚨
蚜	蚜
蚍	蚍
蚋	蚋
蚬	蜆
蚝	蠔
蚧	蚧
唢	嗩
圄	圄
唣	唣
唏	唏
盎	盎
唑	唑
崂	嶗
崃	崍
罡	罡
罟	罟
峪	峪
觊	覬
赅	賅
钰	鈺
钲	鉦
钴	鈷
钵	缽
钹	鈸
钺	鉞
钽	鉭
钼	鉬
钿	鈿
铀	鈾
铂	鉑
铄	鑠
铆	鉚
铈	鈰
铉	鉉
铊	鉈
铋	鉍
铌	鈮
铍	鈹
䥽	鏺
铎	鐸
氩	氬
氤	氤
氦	氦
毪	毪
舐	舐
秣	秣
秫	秫
盉	盉
笄	笄
笕	筧
笊	笊
笏	笏
笆	笆
俸	俸
倩	倩
俵	俵
偌	偌
俳	俳
俶	俶
倬	倬
倏	倏
恁	恁
倭	倭
倪	倪
俾	俾
倜	倜
隼	隼
隽	雋
倌	倌
倥	倥
臬	臬
皋	皋
郫	郫
倨	倨
衄	衄
颀	頎
徕	徠
舫	舫
釜	釜
奚	奚
衾	衾
胯	胯
胱	胱
胴	胴
胭	胭
脍	膾
胼	胼
朕	朕
脒	脒
胺	胺
鸱	鴟
玺	璽
鸲	鴝
狷	狷
猁	猁
狳	狳
猃	獫
狺	狺
逖	逖
桀	桀
袅	裊
饽	餑
凇	凇
栾	欒
挛	攣
亳	亳
疳	疳
疴	痾
疸	疸
疽	疽
痈	癰
疱	皰
痂	痂
痉	痙
衮	袞
凋	凋
颃	頏
恣	恣
旆	旆
旄	旄
旃	旃
阃	閫
阄	鬮
訚	誾
阆	閬
恙	恙
粑	粑
朔	朔
郸	鄲
烜	烜
烨	燁
烩	燴
烊	烊
剡	剡
郯	郯
烬	燼
涑	涑
浯	浯
涞	淶
涟	漣
娑	娑
涅	涅
涠	潿
浞	浞
涓	涓
浥	浥
涔	涔
浜	浜
浠	浠
浣	浣
浚	浚
悚	悚
悭	慳
悝	悝
悒	悒
悌	悌
悛	悛
宸	宸
窈	窈
剜	剜
诹	諏
冢	冢
诼	諑
袒	袒
袢	袢
祯	禎
诿	諉
谀	諛
谂	諗
谄	諂
谇	誶
屐	屐
屙	屙
陬	陬
勐	勐
奘	奘
牂	牂
蚩	蚩
陲	陲
姬	姬
娠	娠
娌	娌
娉	娉
娲	媧
娩	娩
娴	嫻
娣	娣
娓	娓
婀	婀
畚	畚
逡	逡
绠	綆
骊	驪
绡	綃
骋	騁
绥	綏
绦	絛
绨	綈
骎	駸
邕	邕
鸶	鷥
彗	彗
耜	耜
焘	燾
舂	舂
琏	璉
琇	琇
麸	麩
揶	揶
埴	埴
埯	埯
捯	捯
掳	擄
掴	摑
埸	埸
埵	埵
赧	赧
埤	埤
捭	捭
逵	逵
埝	埝
堋	堋
堍	堍
掬	掬
鸷	鷙
掖	掖
捽	捽
掊	掊
堉	堉
掸	撣
捩	捩
掮	掮
悫	愨
埭	埭
埽	埽
掇	掇
掼	摜
聃	聃
菁	菁
萁	萁
菘	菘
堇	堇
萘	萘
萋	萋
菽	菽
菖	菖
萜	萜
萸	萸
萑	萑
棻	棻
菔	菔
菟	菟
萏	萏
萃	萃
菏	菏
菹	菹
菪	菪
菅	菅
菀	菀
萦	縈
菰	菰
菡	菡
梵	梵
梿	槤
梏	梏
觋	覡
桴	桴
桷	桷
梓	梓
棁	梲
桫	桫
棂	欞
啬	嗇
郾	郾
匮	匱
敕	敕
豉	豉
鄄	鄄
酞	酞
酚	酚
戛	戛
硎	硎
硭	硭
硒	硒
硖	硤
硗	磽
硐	硐
硇	硇
硌	硌
鸸	鴯
瓠	瓠
匏	匏
厩	廄
龚	龔
殒	殞
殓	殮
殍	殍
赉	賚
雩	雩
辄	輒
堑	塹
眭	眭
眦	眥
啧	嘖
晡	晡
晤	晤
眺	眺
眵	眵
眸	眸
圊	圊
喏	喏
喵	喵
啉	啉
勖	勖
晞	晞
唵	唵
晗	晗
冕	冕
啭	囀
畦	畦
趺	趺
啮	齧
跄	蹌
蚶	蚶
蛄	蛄
蛎	蠣
蛆	蛆
蚰	蚰
蛊	蠱
圉	圉
蚱	蚱
蛉	蛉
蛏	蟶
蚴	蚴
啁	啁
啕	啕
唿	唿
啐	啐
唼	唼
唷	唷
啖	啖
啵	啵
啶	啶
啷	啷
唳	唳
唰	唰
啜	啜
帻	幘
崚	崚
崦	崦
帼	幗
崮	崮
崤	崤
崆	崆
赇	賕
赈	賑
赊	賒
铑	銠
铒	鉺
铗	鋏
铙	鐃
铟	銦
铠	鎧
铡	鍘
铢	銖
铣	銑
铤	鋌
铧	鏵
铨	銓
铩	鎩
铪	鉿
铫	銚
铬	鉻
铮	錚
铯	銫
铰	鉸
铱	銥
铳	銃
铵	銨
铷	銣
氪	氪
牾	牾
鸹	鴰
秾	穠
逶	逶
笺	箋
筇	筇
笸	笸
笪	笪
笮	笮
笠	笠
笥	笥
笤	笤
笳	笳
笾	籩
笞	笞
偾	僨
偃	偃
偕	偕
偈	偈
傀	傀
偬	傯
偻	僂
皑	皚
皎	皎
鸻	鴴
徜	徜
舸	舸
舻	艫
舴	舴
舷	舷
龛	龕
翎	翎
脬	脬
脘	脘
脲	脲
匐	匐
猗	猗
猡	玀
猞	猞
猝	猝
斛	斛
猕	獼
馗	馗
馃	餜
馄	餛
鸾	鸞
孰	孰
庹	庹
庾	庾
痔	痔
痍	痍
疵	疵
翊	翊
旌	旌
旎	旎
袤	袤
阇	闍
阈	閾
阉	閹
阊	閶
阋	鬩
阍	閽
阏	閼
羟	羥
粝	糲
粕	粕
敝	敝
焐	焐
烯	烯
焓	焓
烽	烽
焖	燜
烷	烷
焗	焗
渍	漬
渚	渚
淇	淇
淅	淅
淞	淞
渎	瀆
涿	涿
淖	淖
挲	挲
淠	淠
涸	涸
渑	澠
淦	淦
淝	淝
淬	淬
涪	涪
淙	淙
涫	涫
渌	淥
淄	淄
惬	愜
悻	悻
悱	悱
惝	惝
惘	惘
悸	悸
惆	惆
惚	惚
惇	惇
惮	憚
窕	窕
谌	諶
谏	諫
扈	扈
皲	皸
谑	謔
裆	襠
袷	袷
裉	裉
谒	謁
谔	諤
谕	諭
谖	諼
谗	讒
谙	諳
谛	諦
谝	諞
逯	逯
郿	郿
隈	隈
粜	糶
隍	隍
隗	隗
婧	婧
婊	婊
婕	婕
娼	娼
婢	婢
婵	嬋
胬	胬
袈	袈
翌	翌
恿	恿
欸	欸
绫	綾
骐	騏
绮	綺
绯	緋
绱	鞝
骒	騍
绲	緄
骓	騅
绶	綬
绺	綹
绻	綣
绾	綰
骖	驂
缁	緇
耠	耠
琫	琫
琵	琵
琶	琶
琪	琪
瑛	瑛
琦	琦
琥	琥
琨	琨
靓	靚
琰	琰
琮	琮
琯	琯
琬	琬
琛	琛
琚	琚
辇	輦
鼋	黿
揳	揳
堞	堞
搽	搽
揸	揸
揠	揠
堙	堙
趄	趄
揖	揖
颉	頡
塄	塄
揿	撳
耋	耋
揄	揄
蛩	蛩
蛰	蟄
塆	壪
摒	摒
揆	揆
掾	掾
聒	聒
葑	葑
葚	葚
靰	靰
靸	靸
葳	葳
葺	葺
葸	葸
萼	萼
葆	葆
葩	葩
葶	葶
蒌	蔞
萱	萱
戟	戟
葭	葭
楮	楮
棼	棼
椟	櫝
棹	棹
椤	欏
棰	棰
赍	齎
椋	椋
椁	槨
椪	椪
棣	棣
椐	椐
鹁	鵓
覃	覃
酤	酤
酢	酢
酡	酡
鹂	鸝
厥	厥
殚	殫
殛	殛
雯	雯
雱	雱
辊	輥
辋	輞
椠	槧
辍	輟
辎	輜
斐	斐
睄	睄
睑	瞼
睇	睇
睃	睃
戢	戢
喋	喋
嗒	嗒
喃	喃
喱	喱
喹	喹
晷	晷
喈	喈
跖	蹠
跗	跗
跞	躒
跚	跚
跎	跎
跏	跏
跆	跆
蛱	蛺
蛲	蟯
蛭	蛭
蛳	螄
蛐	蛐
蛔	蛔
蛞	蛞
蛴	蠐
蛟	蛟
蛘	蛘
喁	喁
喟	喟
啾	啾
嗖	嗖
喑	喑
嗟	嗟
喽	嘍
嗞	嗞
喀	喀
喔	喔
喙	喙
嵘	嶸
嵖	嵖
崴	崴
遄	遄
詈	詈
嵎	嵎
崽	崽
嵬	嵬
嵛	嵛
嵯	嵯
嵝	嶁
嵫	嵫
幄	幄
嵋	嵋
赕	賧
铻	鋙
铼	錸
铿	鏗
锃	鋥
锂	鋰
锆	鋯
锇	鋨
锉	銼
锏	鐧
锑	銻
锒	鋃
锔	鋦
锕	錒
掣	掣
矬	矬
氰	氰
毳	毳
毽	毽
犊	犢
犄	犄
犋	犋
鹄	鵠
犍	犍
嵇	嵇
黍	黍
稃	稃
稂	稂
筚	篳
筵	筵
筌	筌
傣	傣
傈	傈
舄	舄
牍	牘
傥	儻
傧	儐
遑	遑
傩	儺
遁	遁
徨	徨
媭	嬃
畲	畲
弑	弒
颌	頜
翕	翕
釉	釉
鹆	鵒
舜	舜
貂	貂
腈	腈
腌	醃
腓	腓
腆	腆
腴	腴
腑	腑
腚	腚
腱	腱
鱿	魷
鲀	魨
鲂	魴
颍	潁
猢	猢
猹	猹
猥	猥
飓	颶
觞	觴
觚	觚
猱	猱
颎	熲
飧	飧
馇	餷
馊	餿
亵	褻
脔	臠
裒	裒
痣	痣
痨	癆
痦	痦
痞	痞
痤	痤
痫	癇
痧	痧
赓	賡
竦	竦
瓿	瓿
啻	啻
颏	頦
鹇	鷳
阑	闌
阒	闃
阕	闋
粞	粞
遒	遒
孳	孳
焯	焯
焜	焜
焙	焙
焱	焱
鹈	鵜
湛	湛
渫	渫
湮	湮
湎	湎
湜	湜
渭	渭
湍	湍
湫	湫
溲	溲
湟	湟
溆	漵
湲	湲
湔	湔
湉	湉
渥	渥
湄	湄
滁	滁
愠	慍
惺	惺
愦	憒
惴	惴
愀	愀
愎	愎
愔	愔
喾	嚳
寐	寐
谟	謨
扉	扉
裢	褳
裎	裎
裥	襉
祾	祾
祺	祺
谠	讜
幂	冪
谡	謖
谥	諡
谧	謐
遐	遐
孱	孱
弼	弼
巽	巽
骘	騭
媪	媼
媛	媛
婷	婷
巯	巰
翚	翬
皴	皴
婺	婺
骛	騖
缂	緙
缃	緗
缄	緘
彘	彘
缇	緹
缈	緲
缌	緦
缑	緱
缒	縋
缗	緡
飨	饗
耢	耮
瑚	瑚
瑁	瑁
瑜	瑜
瑗	瑗
瑄	瑄
瑕	瑕
遨	遨
骜	驁
韫	韞
髡	髡
塬	塬
鄢	鄢
趔	趔
趑	趑
摅	攄
摁	摁
蜇	蜇
搋	搋
搪	搪
搐	搐
搛	搛
搠	搠
摈	擯
彀	彀
毂	轂
搦	搦
搡	搡
蓁	蓁
戡	戡
蓍	蓍
鄞	鄞
靳	靳
蓐	蓐
蓦	驀
鹋	鶓
蒽	蒽
蓓	蓓
蓖	蓖
蓊	蓊
蒯	蒯
蓟	薊
蓑	蓑
蒿	蒿
蒺	蒺
蓠	蘺
蒟	蒟
蒡	蒡
蒹	蒹
蒴	蒴
蒗	蒗
蓥	鎣
颐	頤
楔	楔
楠	楠
楂	楂
楝	楝
楫	楫
楸	楸
椴	椴
槌	槌
楯	楯
皙	皙
榈	櫚
槎	槎
榉	櫸
楦	楦
楣	楣
楹	楹
椽	椽
裘	裘
剽	剽
甄	甄
酮	酮
酰	酰
酯	酯
酩	酩
蜃	蜃
碛	磧
碓	碓
硼	硼
碉	碉
碚	碚
碇	碇
碜	磣
鹌	鵪
辏	輳
龃	齟
龅	齙
訾	訾
粲	粲
虞	虞
睚	睚
嗪	嗪
韪	韙
嗷	嗷
嗉	嗉
睨	睨
睢	睢
雎	雎
睥	睥
嘟	嘟
嗑	嗑
嗫	囁
嗬	嗬
嗔	嗔
嗝	嗝
戥	戥
嗄	嗄
煦	煦
暄	暄
遢	遢
暌	暌
跬	跬
跶	躂
跸	蹕
跐	跐
跣	跣
跹	躚
跻	躋
蛸	蛸
蜊	蜊
蜍	蜍
蜉	蜉
蜣	蜣
畹	畹
蛹	蛹
嗣	嗣
嗯	嗯
嗥	嗥
嗲	嗲
嗳	噯
嗌	嗌
嗍	嗍
嗨	嗨
嗐	嗐
嗤	嗤
嗵	嗵
罨	罨
嵊	嵊
嵩	嵩
嵴	嵴
骰	骰
锗	鍺
锛	錛
锜	錡
锝	鍀
锞	錁
锟	錕
锢	錮
锨	杴
锩	錈
锭	錠
锱	錙
雉	雉
氲	氳
犏	犏
歃	歃
稞	稞
稗	稗
稔	稔
筠	筠
筢	筢
筮	筮
筲	筲
筱	筱
牒	牒
煲	煲
敫	敫
徭	徭
愆	愆
艄	艄
觎	覦
毹	毹
貊	貊
貅	貅
貉	貉
颔	頷
腠	腠
腩	腩
腼	靦
腭	顎
腧	腧
塍	塍
媵	媵
詹	詹
鲅	鮁
鲆	鮃
鲇	鯰
鲈	鱸
稣	穌
鲋	鮒
鲐	鮐
肄	肄
鹐	鵮
飕	颼
觥	觥
遛	遛
馐	饈
鹑	鶉
亶	亶
瘃	瘃
痱	痱
痼	痼
痿	痿
瘐	瘐
瘁	瘁
瘆	瘮
麂	麂
裔	裔
歆	歆
旒	旒
雍	雍
阖	闔
阗	闐
阙	闕
羧	羧
豢	豢
粳	粳
猷	猷
煳	煳
煜	煜
煨	煨
煅	煅
煊	煊
煸	煸
煺	煺
滟	灩
溱	溱
溘	溘
漭	漭
滢	瀅
溥	溥
溧	溧
溽	溽
裟	裟
溻	溻
溷	溷
滗	潷
滫	滫
溴	溴
滏	滏
滃	滃
滦	灤
溏	溏
滂	滂
滓	滓
溟	溟
滪	澦
愫	愫
慑	懾
慊	慊
鲎	鱟
骞	騫
窦	竇
窠	窠
窣	窣
裱	裱
褚	褚
裨	裨
裾	裾
裰	裰
禊	禊
谩	謾
谪	謫
媾	媾
嫫	嫫
媲	媲
嫒	嬡
嫔	嬪
媸	媸
缙	縉
缜	縝
缛	縟
辔	轡
骝	騮
缟	縞
缡	縭
缢	縊
缣	縑
骟	騸
耥	耥
璈	璈
瑶	瑤
瑭	瑭
獒	獒
觏	覯
慝	慝
嫠	嫠
韬	韜
叆	靉
髦	髦
摽	摽
墁	墁
撂	撂
摞	摞
撄	攖
翥	翥
踅	踅
摭	摭
墉	墉
墒	墒
榖	榖
綦	綦
蔫	蔫
蔷	薔
靺	靺
靼	靼
鞅	鞅
靿	靿
甍	甍
蔸	蔸
蔟	蔟
蔺	藺
戬	戩
蕖	蕖
蔻	蔻
蓿	蓿
斡	斡
鹕	鶘
蓼	蓼
榛	榛
榧	榧
榻	榻
榫	榫
榭	榭
槔	槔
榱	榱
槁	槁
槟	檳
槠	櫧
榷	榷
僰	僰
酽	釅
酶	酶
酹	酹
厮	廝
碡	碡
碴	碴
碣	碣
碲	碲
磋	磋
臧	臧
豨	豨
殡	殯
霆	霆
霁	霽
辕	轅
蜚	蜚
裴	裴
翡	翡
龇	齜
龈	齦
睿	睿
䁖	瞜
睽	睽
嘞	嘞
嘈	嘈
嘌	嘌
嘁	嘁
嘎	嘎
暧	曖
暝	暝
踌	躊
踉	踉
蜞	蜞
蜥	蜥
蜮	蜮
蝈	蟈
蜴	蜴
蜱	蜱
蜩	蜩
蜷	蜷
蜿	蜿
螂	螂
蜢	蜢
嘘	噓
嘡	嘡
鹗	鶚
嘣	嘣
嘤	嚶
嘚	嘚
嗾	嗾
嘧	嘧
罴	羆
罱	罱
幔	幔
嶂	嶂
幛	幛
赙	賻
罂	罌
骷	骷
骶	骶
鹘	鶻
锲	鍥
锴	鍇
锶	鍶
锷	鍔
锸	鍤
锵	鏘
镁	鎂
镂	鏤
犒	犒
箐	箐
箦	簀
箧	篋
箍	箍
箸	箸
箬	箬
箅	箅
箪	簞
箔	箔
箜	箜
箢	箢
箓	籙
毓	毓
僖	僖
儆	儆
僳	僳
僭	僭
劁	劁
僮	僮
魃	魃
魆	魆
睾	睾
艋	艋
鄱	鄱
膈	膈
膑	臏
鲑	鮭
鲔	鮪
鲚	鱭
鲛	鮫
鲟	鱘
獐	獐
觫	觫
雒	雒
夤	夤
馑	饉
銮	鑾
塾	塾
麽	麼
瘌	瘌
瘊	瘊
瘘	瘻
瘙	瘙
廖	廖
韶	韶
旖	旖
膂	膂
阚	闞
鄯	鄯
鲞	鯗
粿	粿
粼	粼
粽	粽
糁	糝
槊	槊
鹚	鶿
熘	熘
熥	熥
潢	潢
漕	漕
滹	滹
漯	漯
漶	漶
潋	瀲
潴	瀦
漪	漪
漉	漉
漳	漳
漩	漩
澉	澉
潍	濰
慵	慵
搴	搴
窨	窨
寤	寤
綮	綮
谮	譖
褡	褡
褙	褙
褓	褓
褛	褸
褊	褊
谯	譙
谰	讕
谲	譎
暨	暨
屣	屣
鹛	鶥
嫣	嫣
嫱	嬙
嫖	嫖
嫦	嫦
嫚	嫚
嫘	嫘
嫡	嫡
鼐	鼐
翟	翟
瞀	瞀
鹜	鶩
骠	驃
缥	縹
缦	縵
缧	縲
缨	纓
骢	驄
缪	繆
缫	繅
耦	耦
耧	耬
瑾	瑾
璜	璜
璀	璀
璎	瓔
璁	璁
璋	璋
璇	璇
奭	奭
髯	髯
髫	髫
撷	擷
撅	撅
赭	赭
撸	擼
鋆	鋆
撙	撙
撺	攛
墀	墀
聩	聵
觐	覲
鞑	韃
蕙	蕙
鞒	鞽
蕈	蕈
蕨	蕨
蕤	蕤
蕞	蕞
蕺	蕺
瞢	瞢
蕃	蕃
蕲	蘄
赜	賾
槿	槿
樯	檣
槭	槭
樗	樗
樘	樘
樊	樊
槲	槲
醌	醌
醅	醅
靥	靨
魇	魘
餍	饜
磔	磔
磙	磙
霈	霈
辘	轆
龉	齬
龊	齪
觑	覷
瞌	瞌
瞋	瞋
瞑	瞑
嘭	嘭
噎	噎
噶	噶
颙	顒
暹	暹
噘	噘
踔	踔
踝	踝
踟	踟
踒	踒
踬	躓
踮	踮
踯	躑
踺	踺
踞	踞
蝽	蝽
蝾	蠑
蝻	蝻
蝰	蝰
蝮	蝮
螋	螋
蝓	蝓
蝣	蝣
蝼	螻
噗	噗
嘬	嘬
颚	顎
噍	噍
噢	噢
噙	噙
噜	嚕
噌	噌
噔	噔
颛	顓
幞	幞
幡	幡
嶙	嶙
嶝	嶝
骺	骺
骼	骼
骸	骸
镊	鑷
镉	鎘
镌	鐫
镍	鎳
镏	鎦
镒	鎰
镓	鎵
镔	鑌
稷	稷
箴	箴
篑	簣
篁	篁
篌	篌
篆	篆
牖	牖
儋	儋
徵	徵
磐	磐
虢	虢
鹞	鷂
膘	膘
滕	滕
鲠	鯁
鲡	鱺
鲢	鰱
鲣	鰹
鲥	鰣
鲧	鯀
鲩	鯇
獗	獗
獠	獠
觯	觶
馓	饊
馔	饌
麾	麾
廛	廛
瘛	瘛
瘼	瘼
瘢	瘢
瘠	瘠
齑	齏
羯	羯
羰	羰
𥻗	𥻗
遴	遴
糌	糌
糍	餈
糅	糅
熜	熜
熵	熵
熠	熠
澍	澍
澌	澌
潸	潸
潦	潦
潲	潲
鋈	鋈
潟	潟
潼	潼
潺	潺
憬	憬
憧	憧
寮	寮
窳	窳
谳	讞
褴	襤
褟	褟
褫	褫
谵	譫
熨	熨
屦	屨
嬉	嬉
勰	勰
戮	戮
蝥	蝥
缬	纈
缮	繕
缯	繒
骣	驏
畿	畿
耩	耩
耨	耨
耪	耪
璞	璞
璟	璟
靛	靛
璠	璠
璘	璘
聱	聱
螯	螯
髻	髻
髭	髭
髹	髹
擀	擀
熹	熹
甏	甏
擞	擻
縠	縠
磬	磬
颞	顳
蕻	蕻
鞘	鞘
颟	顢
薤	薤
薨	薨
檠	檠
薏	薏
薮	藪
薜	薜
薅	薅
樾	樾
橛	橛
橇	橇
樵	樵
檎	檎
橹	櫓
樽	樽
樨	樨
橼	櫞
墼	墼
橐	橐
翮	翮
醛	醛
醐	醐
醍	醍
醚	醚
磲	磲
赝	贗
飙	飆
殪	殪
霖	霖
霏	霏
霓	霓
錾	鏨
辚	轔
臻	臻
遽	遽
氅	氅
瞟	瞟
瞠	瞠
瞰	瞰
嚄	嚄
嚆	嚆
噤	噤
暾	暾
蹀	蹀
踹	踹
踵	踵
踽	踽
蹉	蹉
蹁	蹁
螨	蟎
蟒	蟒
螈	螈
螅	螅
螭	螭
螠	螠
螟	螟
噱	噱
噬	噬
噫	噫
噻	噻
噼	噼
罹	罹
圜	圜
䦃	鐯
镖	鏢
镗	鏜
镘	鏝
镚	鏰
镛	鏞
镝	鏑
镞	鏃
镠	鏐
氇	氌
氆	氆
憩	憩
穑	穡
篝	篝
篥	篥
篦	篦
篪	篪
篙	篙
盥	盥
劓	劓
翱	翱
魉	魎
魈	魈
徼	徼
歙	歙
膳	膳
膦	膦
膙	膙
鲮	鯪
鲱	鯡
鲲	鯤
鲳	鯧
鲴	鯝
鲵	鯢
鲷	鯛
鲻	鯔
獴	獴
獭	獺
獬	獬
邂	邂
鹧	鷓
廨	廨
赟	贇
瘰	瘰
廪	廩
瘿	癭
瘵	瘵
瘴	瘴
癃	癃
瘳	瘳
斓	斕
麇	麇
麈	麈
嬴	嬴
壅	壅
羲	羲
糗	糗
瞥	瞥
甑	甑
燎	燎
燠	燠
燔	燔
燧	燧
濑	瀨
濉	濉
潞	潞
澧	澧
澹	澹
澥	澥
澶	澶
濂	濂
褰	褰
寰	寰
窸	窸
褶	褶
禧	禧
嬖	嬖
犟	犟
隰	隰
嬗	嬗
颡	顙
缱	繾
缲	繰
缳	繯
璨	璨
璩	璩
璐	璐
璪	璪
螫	螫
擤	擤
壕	壕
觳	觳
罄	罄
擢	擢
薹	薹
鞡	鞡
鞬	鞬
薷	薷
薰	薰
藓	蘚
藁	藁
檄	檄
檩	檁
懋	懋
醢	醢
翳	翳
礅	礅
磴	磴
鹩	鷯
龋	齲
龌	齷
豳	豳
壑	壑
黻	黻
嚏	嚏
嚅	嚅
蹑	躡
蹒	蹣
蹊	蹊
蟥	蟥
螬	螬
螵	螵
疃	疃
螳	螳
蟑	蟑
嚓	嚓
羁	羈
罽	罽
罾	罾
嶷	嶷
黜	黜
黝	黝
髁	髁
髀	髀
镡	鐔
镢	钁
镣	鐐
镦	鐓
镧	鑭
镩	鑹
镪	鏹
镫	鐙
罅	罅
黏	黏
簌	簌
篾	篾
篼	篼
簖	籪
簋	簋
鼢	鼢
黛	黛
儡	儡
鹪	鷦
鼾	鼾
皤	皤
魍	魍
龠	龠
繇	繇
貘	貘
邈	邈
貔	貔
臌	臌
膻	羶
臆	臆
臃	臃
鲼	鱝
鲽	鰈
鳀	鯷
鳃	鰓
鳅	鰍
鳇	鰉
鳊	鯿
螽	螽
燮	燮
鹫	鷲
襄	襄
糜	糜
縻	縻
膺	膺
癍	癍
麋	麋
懑	懣
濡	濡
濮	濮
濞	濞
濠	濠
濯	濯
蹇	蹇
謇	謇
邃	邃
襁	襁
檗	檗
擘	擘
孺	孺
隳	隳
嬷	嬤
蟊	蟊
鹬	鷸
鍪	鍪
鏊	鏊
鳌	鰲
鬈	鬈
鬃	鬃
瞽	瞽
鞯	韉
鞨	鞨
鞫	鞫
鞧	鞧
鞣	鞣
藜	藜
藠	藠
藩	藩
醪	醪
蹙	蹙
礓	礓
燹	燹
餮	餮
瞿	瞿
曛	曛
颢	顥
曜	曜
躇	躇
蹚	蹚
鹭	鷺
蟛	蟛
蟪	蟪
蟠	蟠
蟮	蟮
鹮	䴉
黠	黠
黟	黟
髅	髏
髂	髂
镬	鑊
镭	鐳
镯	鐲
馥	馥
簟	簟
簪	簪
鼬	鼬
雠	讎
艟	艟
鳎	鰨
鳏	鰥
鳐	鰩
癞	癩
癔	癔
癜	癜
癖	癖
糨	糨
蹩	蹩
鎏	鎏
懵	懵
彝	彝
邋	邋
鬏	鬏
攉	攉
攒	攢
鞲	韝
鞴	鞴
藿	藿
蘧	蘧
蘅	蘅
麓	麓
醮	醮
醯	醯
酃	酃
霪	霪
霭	靄
霨	霨
黼	黼
嚯	嚯
蹰	躕
蹶	蹶
蹽	蹽
蹼	蹼
蹴	蹴
蹾	蹾
蹿	躥
蠖	蠖
蠓	蠓
蟾	蟾
蠊	蠊
黢	黢
髋	髖
髌	髕
镲	鑔
籀	籀
籁	籟
齁	齁
魑	魑
艨	艨
鳓	鰳
鳔	鰾
鳕	鱈
鳗	鰻
鳙	鱅
麒	麒
鏖	鏖
羸	羸
㸆	㸆
瀚	瀚
瀣	瀣
瀛	瀛
襦	襦
谶	讖
襞	襞
骥	驥
缵	纘
瓒	瓚
攘	攘
蘩	蘩
蘖	櫱
醴	醴
霰	霰
酆	酆
矍	矍
曦	曦
躅	躅
鼍	鼉
巉	巉
黩	黷
黥	黥
黪	黲
镳	鑣
镴	鑞
黧	黧
纂	纂
璺	璺
鼯	鼯
臜	臢
鳜	鱖
鳝	鱔
鳟	鱒
獾	獾
孀	孀
骧	驤
瓘	瓘
鼙	鼙
醺	醺
礴	礴
颦	顰
曩	曩
鳢	鱧
癫	癲
麝	麝
夔	夔
爝	爝
灏	灝
禳	禳
鐾	鐾
羼	羼
蠡	蠡
耱	耱
懿	懿
蘸	蘸
鹳	鸛
霾	霾
氍	氍
饕	饕
躐	躐
髑	髑
镵	鑱
穰	穰
饔	饔
鬻	鬻
鬟	鬟
趱	趲
攫	攫
攥	攥
颧	顴
躜	躦
鼹	鼴
癯	癯
麟	麟
蠲	蠲
蠹	蠹
躞	躞
衢	衢
鑫	鑫
灞	灞
襻	襻
纛	纛
鬣	鬣
攮	攮
囔	囔
馕	饢
戆	戇
爨	爨
齉	齉
亍	亍
尢	尢
彳	彳
卬	卬
殳	殳
𠙶	𠙶
毌	毌
邘	邘
戋	戔
圢	圢
氕	氕
伋	伋
仝	仝
冮	冮
氿	氿
汈	汈
氾	氾
忉	忉
宄	宄
𬣙	𬣙
讱	訒
扞	扞
圲	圲
圫	圫
芏	芏
芃	芃
朳	朳
朸	朸
𨙸	𨙸
邨	邨
吒	吒
吖	吖
屼	屼
屾	屾
辿	辿
钆	釓
仳	仳
伣	俔
伈	伈
癿	癿
甪	甪
邠	邠
犴	犴
冱	冱
邡	邡
闫	閆
𬇕	𬇕
汋	汋
䜣	訢
讻	訩
𬣞	𬣞
孖	孖
𬘓	𬘓
纩	纊
玒	玒
玓	玓
玘	玘
玚	瑒
刬	剗
𫭟	𫭟
坜	壢
坉	坉
扽	扽
𫭢	𫭢
坋	坋
扺	扺
㧑	撝
毐	毐
芰	芰
芣	芣
苊	苊
苉	苉
芘	芘
芴	芴
芠	芠
𫇭	蒍
芤	芤
杕	杕
杙	杙
杄	杄
杧	杧
杩	榪
尪	尪
尨	尨
轪	軑
𫐄	軏
坒	坒
芈	羋
旴	旴
旵	旵
呙	咼
㕮	㕮
岍	岍
𫵷	𫵷
岠	岠
岜	岜
呇	呇
冏	冏
觃	覎
岙	岙
伾	伾
㑇	㑳
伭	伭
佖	佖
伲	伲
佁	佁
飏	颺
狃	狃
闶	閌
汧	汧
汫	汫
𣲘	潕
𣲗	湋
沄	沄
沘	沘
𬇙	𬇙
汭	汭
㳇	㳇
沇	沇
忮	忮
忳	忳
忺	忺
𬣡	𬣡
祃	禡
诇	詗
邲	邲
诎	詘
诐	詖
屃	屓
𫸩	彄
岊	岊
阽	阽
䢺	䢺
阼	阼
妧	妧
妘	妘
𨚕	𨚕
纮	紘
驲	馹
𫘜	馼
纻	紵
𬘘	𬘘
𫘝	駃
纼	紖
玤	玤
玞	玞
玱	瑲
玟	玟
邽	邽
邿	邿
坥	坥
坰	坰
坬	坬
坽	坽
弆	弆
耵	耵
䢼	䢼
𦭜	𦭜
茋	茋
苧	薴
苾	苾
苠	苠
枅	枅
㭎	棡
枘	枘
枍	枍
矼	矼
矻	矻
匼	匼
𬨂	𬨂
𬀩	暐
𬀪	𬀪
旿	旿
昇	昇
昄	昄
昒	昒
昈	昈
咉	咉
咇	咇
咍	咍
岵	岵
岽	崬
岨	岨
岞	岞
峂	峂
㟃	㟃
囷	囷
𬬩	𬬩
钐	釤
钔	鍆
钖	鍚
牥	牥
佴	佴
垈	垈
侁	侁
侹	侹
佸	佸
佺	佺
隹	隹
㑊	㑊
侂	侂
佽	佽
侘	侘
郈	郈
舠	舠
郐	鄶
郃	郃
攽	攽
肭	肭
肸	肸
肷	肷
狉	狉
狝	獮
饳	飿
忞	忞
於	於
炌	炌
炆	炆
泙	泙
沺	沺
泂	泂
泜	泜
泃	泃
泇	泇
怊	怊
峃	嶨
穸	穸
祋	祋
祊	祊
𫍣	詷
𬣳	𬣳
𬩽	𬩽
鸤	鳲
弢	弢
弨	弨
陑	陑
𬮿	𬮿
陎	陎
𬯀	𬯀
卺	巹
乸	乸
妭	妭
姈	姈
𫰛	娙
迳	逕
叕	叕
𬳵	𬳵
驵	駔
𬳶	𬳶
䌹	絅
驺	騶
𫠊	䮄
绋	紼
绐	紿
砉	砉
耔	耔
㛃	㛃
玶	玶
珇	珇
珅	珅
𬍛	𬍛
珋	珋
玹	玹
珌	珌
玿	玿
韨	韍
垚	垚
垯	墶
垙	垙
垲	塏
埏	埏
垍	垍
耇	耇
鿍	鿍
垎	垎
垴	堖
垟	垟
垞	垞
挓	挓
垵	垵
垏	垏
拶	拶
荖	荖
荁	荁
荙	薘
荛	蕘
茈	茈
茽	茽
荄	荄
茺	茺
𬜬	𬜬
荓	荓
茳	茳
𦰡	𦰡
茛	茛
荭	葒
㭕	㭕
柷	柷
柃	柃
柊	柊
枹	枹
栐	栐
柖	柖
郚	郚
剅	剅
䴓	鳾
迺	迺
厖	厖
砆	砆
砑	砑
砄	砄
耏	耏
奓	奓
䶮	龑
轵	軹
轷	軤
轹	轢
轺	軺
昺	昺
𪾢	睍
昽	曨
盷	盷
咡	咡
咺	咺
昳	昳
昣	昣
哒	噠
昤	昤
昫	昫
昡	昡
咥	咥
昪	昪
虷	虷
虸	虸
哃	哃
峘	峘
耑	耑
峛	峛
𪨰	𪨰
峗	峗
峧	峧
帡	帡
钘	鈃
𫓧	鈇
钜	鉅
𬬮	𬬮
𬬱	𬬱
𬬭	錀
钪	鈧
钬	鈥
钭	鈄
矧	矧
秬	秬
俫	倈
舁	舁
俜	俜
俙	俙
俍	俍
垕	垕
衎	衎
舣	艤
弇	弇
侴	侴
鸧	鶬
䏡	䏡
胠	胠
𦙶	𦙶
胈	胈
胩	胩
胣	胣
朏	朏
飐	颭
訄	訄
饻	餏
庤	庤
疢	疢
炣	炣
炟	炟
㶲	㶲
洭	洭
洘	洘
洓	洓
洿	洿
㳚	㳚
泚	泚
浈	湞
浉	溮
洸	洸
洑	洑
洢	洢
洈	洈
洚	洚
洺	洺
洨	洨
浐	滻
㳘	㳘
洴	洴
洣	洣
恔	恔
宬	宬
窀	窀
扂	扂
袆	褘
祏	祏
祐	祐
祕	秘
叚	叚
陧	隉
陞	陞
娀	娀
姞	姞
姱	姱
姤	姤
姶	姶
姽	姽
枲	枲
绖	絰
骃	駰
𬘡	𬘡
𬳽	𬳽
𬘩	𬘩
𫄧	綖
彖	彖
骉	驫
恝	恝
珪	珪
珛	珛
珹	珹
琊	琊
玼	玼
珖	珖
𪟝	勣
珽	珽
珦	珦
珫	珫
珒	珒
𬍤	𬍤
珢	珢
珕	珕
珝	珝
𫭼	𫭼
埗	埗
垾	垾
垺	垺
埆	埆
垿	垿
埌	埌
埇	埇
莰	莰
茝	茝
𬜯	𬜯
鄀	鄀
莶	薟
莝	莝
䓖	藭
莙	莙
栻	栻
桠	椏
𬂩	𬂩
桄	桄
梠	梠
栴	栴
梴	梴
栒	栒
酎	酎
酏	酏
𫠆	頍
砵	砵
砠	砠
砫	砫
砬	砬
硁	硜
恧	恧
翃	翃
郪	郪
𨐈	輄
辀	輈
辁	輇
𬌗	𬌗
剕	剕
赀	貲
哢	哢
晅	晅
晊	晊
唝	嗊
哳	哳
哱	哱
冔	冔
晔	曄
晐	晐
晖	暉
畖	畖
蚄	蚄
蚆	蚆
𫑡	鄳
帱	幬
崁	崁
峿	峿
𪨶	輋
崄	嶮
帨	帨
崀	崀
赆	贐
𬬸	𬬸
钷	鉕
𬬻	鑪
𬬹	𬬹
𬬿	𬬿
𬭁	𬭁
眚	眚
甡	甡
笫	笫
倻	倻
倴	倴
脩	脩
倮	倮
倕	倕
倞	倞
𫢸	僤
倓	倓
倧	倧
衃	衃
虒	虒
舭	舭
舯	舯
舥	舥
瓞	瓞
鬯	鬯
鸰	鴒
脎	脎
朓	朓
胲	胲
虓	虓
鱽	魛
狴	狴
峱	峱
狻	狻
眢	眢
𫗧	餗
勍	勍
痄	痄
疰	疰
痃	痃
竘	竘
羖	羖
羓	羓
桊	桊
敉	敉
烠	烠
烔	烔
烶	烶
烻	烻
𬊈	𬊈
涍	涍
浡	浡
浭	浭
浬	浬
涄	涄
涢	溳
涐	涐
浰	浰
浟	浟
浛	浛
浼	浼
浲	浲
涘	涘
悈	悈
悃	悃
悢	悢
𬒈	𬒈
宧	宧
窅	窅
窊	窊
窎	窵
扅	扅
扆	扆
袪	袪
袗	袗
袯	襏
祧	祧
隺	隺
堲	堲
疍	疍
𨺙	𨺙
陴	陴
烝	烝
砮	砮
㛚	㛚
哿	哿
翀	翀
翂	翂
剟	剟
𬳿	𬳿
𫄨	絺
绤	綌
骍	騂
𬘫	𬘫
䂮	䂮
琎	璡
珸	珸
珵	珵
琄	琄
琈	琈
琀	琀
珺	珺
掭	掭
堎	堎
堐	堐
埼	埼
掎	掎
埫	埫
堌	堌
晢	晢
𫮃	墠
掞	掞
埪	埪
壸	壼
㙍	㙍
聍	聹
菝	菝
萚	蘀
菥	菥
莿	莿
䓫	䓫
勚	勩
䓬	䓬
萆	萆
菂	菂
菍	菍
菼	菼
萣	萣
䓨	罃
菉	菉
䓛	䓛
梼	檮
梽	梽
桲	桲
梾	棶
桯	桯
梣	梣
梌	梌
桹	桹
敔	敔
厣	厴
硔	硔
鿎	䃮
硙	磑
硚	礄
硊	硊
硍	硍
勔	勔
䴕	鴷
龁	齕
逴	逴
唪	唪
啫	啫
翈	翈
㫰	㫰
晙	晙
畤	畤
𬱖	𬱖
趼	趼
跂	跂
蛃	蛃
蚲	蚲
𬟽	𬟽
蚺	蚺
啴	嘽
䎃	䎃
崧	崧
崟	崟
崞	崞
崒	崒
崌	崌
崡	崡
铏	鉶
𫓯	銈
𫟹	鉷
铕	銪
𫟼	鐽
铖	鋮
铘	鋣
铚	銍
铞	銱
铥	銩
铴	鐋
牻	牻
牿	牿
稆	穭
笱	笱
笯	笯
偰	偰
偡	偡
鸺	鵂
偭	偭
偲	偲
偁	偁
㿠	㿠
鄅	鄅
偓	偓
徛	徛
衒	衒
舳	舳
舲	舲
鸼	鵃
悆	悆
鄃	鄃
瓻	瓻
䝙	貙
脶	腡
脞	脞
脟	脟
䏲	䏲
鱾	魢
猇	猇
猊	猊
猄	猄
觖	觖
𠅤	𠅤
庱	庱
庼	廎
庳	庳
痓	痓
䴔	鵁
竫	竫
堃	堃
阌	閿
羝	羝
羕	羕
焆	焆
烺	烺
焌	焌
淏	淏
𬇹	𬇹
淟	淟
淜	淜
淴	淴
淯	淯
湴	湴
涴	涴
𬍡	𬍡
㥄	㥄
惛	惛
惔	惔
悰	悰
惙	惙
寁	寁
逭	逭
𬤇	𬤇
𫍯	諴
袼	袼
裈	褌
祲	祲
𬤊	𬤊
𫍲	謏
谞	諝
艴	艴
弸	弸
弶	弶
𬯎	𬯎
隃	隃
婞	婞
娵	娵
婼	婼
媖	媖
婳	嫿
婍	婍
婌	婌
婫	婫
婤	婤
婘	婘
婠	婠
𬘬	𬘬
𬘭	𬘭
𬴂	𬴂
𫘦	騊
绹	綯
𫟅	綡
𬘯	𬘯
骕	驌
𫘧	騄
絜	絜
珷	珷
琲	琲
琡	琡
琟	琟
琔	琔
琭	琭
堾	堾
堼	堼
揕	揕
㙘	㙘
堧	堧
喆	喆
堨	堨
塅	塅
堠	堠
絷	縶
𪣻	塿
𡎚	𡎚
葜	葜
惎	惎
萳	萳
葙	葙
靬	靬
葴	葴
蒇	蕆
蒈	蒈
鄚	鄚
蒉	蕢
蓇	蓇
萩	萩
蒐	蒐
葰	葰
葎	葎
鄑	鄑
蒎	蒎
葖	葖
蒄	蒄
萹	萹
棤	棤
棽	棽
棫	棫
椓	椓
椑	椑
𬃊	𬃊
鹀	鵐
椆	椆
棓	棓
棬	棬
棪	棪
椀	椀
楗	楗
𬷕	𬷕
甦	甦
酦	醱
觌	覿
奡	奡
皕	皕
硪	硪
欹	欹
詟	讋
𫐐	輗
辌	輬
棐	棐
龂	齗
𬹼	𬹼
黹	黹
牚	牚
睎	睎
晫	晫
晪	晪
晱	晱
𧿹	𧿹
蛑	蛑
畯	畯
斝	斝
喤	喤
崶	崶
嵁	嵁
𫶇	嵽
崾	崾
嵅	嵅
崿	崿
嵚	嶔
翙	翽
𫖮	顗
圌	圌
圐	圐
赑	贔
淼	淼
赒	賙
鿏	䥑
铹	鐒
𬭊	𨧀
铽	鋱
𨱇	銶
𫓶	鋗
锊	鋝
锍	鋶
锎	鐦
𬭎	𬭎
锓	鋟
犇	犇
颋	頲
稌	稌
筀	筀
筘	筘
筜	簹
筥	筥
筅	筅
傃	傃
傉	傉
翛	翛
傒	傒
傕	傕
舾	舾
畬	畬
𫖯	頫
脿	脿
腘	膕
䐃	䐃
腙	腙
腒	腒
𬱟	𬱟
鲃	䰾
猰	猰
𫛭	鵟
猯	猯
㺄	㺄
馉	餶
凓	凓
鄗	鄗
𫷷	廞
廋	廋
廆	廆
鄌	鄌
粢	粢
遆	遆
旐	旐
𬮱	𬮱
焞	焞
𬊤	𬊤
欻	欻
𣸣	濆
溚	溚
溁	濚
湝	湝
渰	渰
湓	湓
㴔	㴔
渟	渟
溠	溠
渼	渼
溇	漊
湣	湣
湑	湑
溞	溞
愐	愐
愃	愃
敩	斆
甯	甯
棨	棨
扊	扊
裣	襝
祼	祼
婻	婻
媆	媆
媞	媞
㛹	㛹
媓	媓
媂	媂
媄	媄
毵	毿
矞	矞
𬴃	𬴃
𫘨	騠
缊	縕
缐	線
骙	騤
瑃	瑃
瑓	瑓
瑅	瑅
瑆	瑆
䴖	鶄
瑖	瑖
瑝	瑝
瑔	瑔
瑀	瑀
𤧛	𤧛
瑳	瑳
瑂	瑂
嶅	嶅
瑑	瑑
遘	遘
髢	髢
塥	塥
堽	堽
赪	赬
摛	摛
塝	塝
搒	搒
搌	搌
蒱	蒱
蒨	蒨
蓏	蓏
蔀	蔀
蓢	蓢
蓂	蓂
蒻	蒻
蓣	蕷
椹	椹
楪	楪
榃	榃
榅	榲
楒	楒
楞	楞
楩	楩
榇	櫬
椸	椸
楙	楙
歅	歅
𬪩	𬪩
碃	碃
碏	碏
𬒔	𬒔
碈	碈
䃅	磾
硿	硿
鄠	鄠
辒	轀
𬨎	𬨎
𫐓	輮
龆	齠
觜	觜
䣘	䣘
暕	暕
鹍	鵾
𫫇	𫫇
㬊	㬊
暅	𣈶
跱	跱
蜐	蜐
蜎	蜎
嵲	嵲
赗	賵
骱	骱
锖	錆
𫓹	錤
锘	鍩
锳	鍈
锧	鑕
锪	鍃
𬭚	𬭚
锫	錇
锬	錟
𬭛	𨨏
稑	稑
稙	稙
䅟	穇
𬕂	𬕂
筻	筻
筼	篔
筶	筶
筦	筦
筤	筤
傺	傺
鹎	鵯
僇	僇
艅	艅
艉	艉
谼	谼
貆	貆
腽	膃
腨	腨
腯	腯
鲉	鮋
鲊	鮓
鲌	鮊
䲟	鮣
𬶋	鮈
𬶍	鮀
鲏	鮍
雊	雊
猺	猺
飔	颸
觟	觟
𦝼	膢
馌	饁
裛	裛
廒	廒
瘀	瘀
瘅	癉
鄘	鄘
鹒	鶊
鄜	鄜
麀	麀
鄣	鄣
阘	闒
𫔶	闑
煁	煁
煃	煃
煴	熅
煋	煋
煟	煟
煓	煓
滠	灄
溍	溍
溹	溹
滆	滆
滉	滉
溦	溦
溵	溵
漷	漷
滧	滧
滘	滘
滍	滍
愭	愭
慥	慥
慆	慆
塱	塱
𫌀	襀
裼	裼
禋	禋
禔	禔
禘	禘
禒	禒
谫	譾
鹔	鷫
𫖳	頵
愍	愍
嫄	嫄
媱	媱
戤	戤
勠	勠
戣	戣
𫘪	騵
𫘬	騱
缞	縗
耤	耤
瑧	瑧
𫞩	璊
瑨	瑨
瑱	瑱
瑷	璦
瑢	瑢
斠	斠
摏	摏
墕	墕
墈	墈
墐	墐
墘	墘
摴	摴
銎	銎
𡐓	𡐓
墚	墚
撖	撖
𪤗	𪤗
靽	靽
鞁	鞁
蔌	蔌
蔈	蔈
蓰	蓰
蔹	蘞
蔊	蔊
嘏	嘏
榰	榰
榑	榑
槚	檟
𣗋	欓
槜	槜
榍	榍
疐	疐
𬸘	𬸘
酺	酺
酾	釃
酲	酲
酴	酴
碶	碶
䃎	䃎
𬒗	𬒗
碨	碨
𥔲	𥔲
碹	碹
碥	碥
劂	劂
𫚖	鮆
䴗	鶪
夥	夥
瞍	瞍
鹖	鶡
㬎	㬎
跽	跽
蜾	蜾
幖	幖
嶍	嶍
圙	圙
𨱏	鎝
锺	鍾
锼	鎪
锽	鍠
𬭤	𬭤
锾	鍰
锿	鎄
镃	鎡
镄	鐨
镅	鎇
馝	馝
鹙	鶖
箨	籜
箖	箖
劄	劄
僬	僬
僦	僦
僔	僔
僎	僎
槃	槃
㙦	㙦
鲒	鮚
鲕	鮞
𫚕	鰤
鲖	鮦
鲗	鰂
鲘	鮜
鲙	鱠
𬶐	𬶐
𬶏	鮠
𩽾	鮟
夐	夐
獍	獍
飗	飀
𬸚	𬸚
凘	凘
廑	廑
廙	廙
瘗	瘞
瘥	瘥
瘕	瘕
鲝	鮺
鄫	鄫
熇	熇
漹	漹
漖	漖
潆	瀠
漤	漤
潩	潩
漼	漼
漴	漴
㽏	㽏
漈	漈
漋	漋
漻	漻
慬	慬
窬	窬
窭	窶
㮾	㮾
𬤝	𬤝
褕	褕
禛	禛
禚	禚
隩	隩
嫕	嫕
嫭	嫭
嫜	嫜
嫪	嫪
𬙂	𬙂
㻬	㻬
麹	麴
璆	璆
漦	漦
叇	靆
墣	墣
墦	墦
墡	墡
劐	劐
薁	薁
蕰	薀
蔃	蔃
鼒	鼒
槱	槱
鹝	鷊
磏	磏
磉	磉
殣	殣
慭	憖
霅	霅
暵	暵
暲	暲
暶	暶
踦	踦
踣	踣
䗖	螮
蝘	蝘
蝲	蝲
蝤	蝤
噇	噇
噂	噂
噀	噀
罶	罶
嶲	嶲
嶓	嶓
㠇	㠇
嶟	嶟
嶒	嶒
镆	鏌
镈	鎛
镋	钂
镎	鎿
𬭩	𬭩
镕	鎔
稹	稹
儇	儇
皞	皞
皛	皛
䴘	鷉
艎	艎
艏	艏
鹟	鶲
𩾃	鮸
鲦	鰷
鲪	鮶
鲬	鯒
橥	櫫
觭	觭
鹠	鶹
鹡	鶺
糇	餱
糈	糈
翦	翦
鹢	鷁
鹣	鶼
熛	熛
潖	潖
潵	潵
㵐	㵐
澂	澂
澛	瀂
瑬	瑬
潽	潽
潾	潾
潏	潏
憭	憭
憕	憕
𬸣	𬸣
戭	戭
褯	褯
禤	禤
𫍽	譞
嫽	嫽
遹	遹
𬴊	𬴊
璥	璥
璲	璲
璒	璒
憙	憙
擐	擐
鄹	鄹
薳	薳
鞔	鞔
黇	黇
𬞟	𬞟
蕗	蕗
薢	薢
蕹	蕹
橞	橞
橑	橑
橦	橦
醑	醑
觱	觱
磡	磡
𥕢	𥕢
磜	磜
豮	豶
𫟦	䡵
𬺈	𬺈
𫠜	齯
鹾	鹺
虤	虤
暿	暿
曌	曌
曈	曈
㬚	㬚
蹅	蹅
踶	踶
䗛	䗛
螗	螗
疁	疁
㠓	㠓
幪	幪
𪩘	巘
嶦	嶦
𬭬	𬭬
𨱑	鐄
𬭯	𬭯
馞	馞
穄	穄
篚	篚
篯	籛
簉	簉
鼽	鼽
衠	衠
盦	盦
螣	螣
縢	縢
鲭	鯖
鲯	鯕
鲰	鯫
鲺	鯴
鲹	鰺
𫗴	饘
亸	嚲
癀	癀
瘭	瘭
𬸦	𬸦
羱	羱
糒	糒
燋	燋
熻	熻
燊	燊
燚	燚
燏	燏
濩	濩
濋	濋
澪	澪
澽	澽
澴	澴
澭	澭
澼	澼
憷	憷
憺	憺
懔	懍
黉	黌
嬛	嬛
鹨	鷚
翯	翯
𫄷	繶
璱	璱
𤩽	瓛
璬	璬
璮	璮
髽	髽
擿	擿
薿	薿
薸	薸
檑	檑
櫆	櫆
檞	檞
醨	醨
繄	繄
磹	磹
磻	磻
瞫	瞫
瞵	瞵
蹐	蹐
蟏	蠨
㘎	㘚
𬭳	𨭎
镤	鏷
𬭶	𨭆
𫔍	鐇
镥	鑥
镨	鐠
𬭸	𬭸
𨱔	鐏
𬭼	𬭼
𫔎	鐍
矰	矰
穙	穙
穜	穜
穟	穟
簕	簕
簃	簃
簏	簏
儦	儦
魋	魋
斶	斶
艚	艚
𬸪	鷭
谿	谿
䲠	鰆
𬶟	鯻
鲾	鰏
𬶠	𬶠
鲿	鱨
鳁	鰮
鳂	鰃
鳈	鰁
鳉	鱂
獯	獯
䗪	䗪
馘	馘
襕	襴
襚	襚
𬶨	𬶨
螱	螱
甓	甓
嬬	嬬
嬥	嬥
𦈡	繻
𫄸	纁
瓀	瓀
釐	釐
鬶	鬹
爇	爇
鞳	鞳
鞮	鞮
𬟁	𬟁
藟	藟
藦	藦
藨	藨
鹲	鸏
檫	檫
黡	黶
礞	礞
礌	礌
𥖨	𥖨
蹢	蹢
蹜	蹜
蟫	蟫
䗴	䗴
嚚	嚚
髃	髃
镮	鐶
镱	鐿
酂	酇
馧	馧
簠	簠
簝	簝
簰	簰
鼫	鼫
鼩	鼩
皦	皦
臑	臑
䲢	鰧
鳑	鰟
鳒	鰜
鹱	鸌
鹯	鸇
癗	癗
𦒍	𦒍
旞	旞
翷	翷
冁	囅
䎖	䎖
瀔	瀔
瀍	瀍
瀌	瀌
襜	襜
䴙	鸊
𬙊	𬙊
嚭	嚭
㰀	㰀
鬷	鬷
醭	醭
蹯	蹯
蠋	蠋
翾	翾
鳘	鰵
儳	儳
儴	儴
鼗	鼗
𬶭	𬶭
𩾌	鱇
鳚	䲁
鳛	鰼
麑	麑
麖	麖
蠃	蠃
彟	彠
嬿	嬿
鬒	鬒
蘘	蘘
欂	欂
醵	醵
颥	顬
甗	甗
𨟠	𨟠
巇	巇
酅	酅
髎	髎
犨	犨
𬶮	𬶮
𨭉	𨭉
㸌	㸌
爔	爔
瀱	瀱
瀹	瀹
瀼	瀼
瀵	瀵
襫	襫
孅	孅
骦	驦
𬙋	𬙋
耰	耰
𤫉	𤫉
瓖	瓖
鬘	鬘
趯	趯
𬺓	𬺓
罍	罍
鼱	鼱
鳠	鱯
鳡	鱤
鳣	鱣
爟	爟
爚	爚
灈	灈
韂	韂
糵	糵
蘼	蘼
礵	礵
鹴	鸘
躔	躔
皭	皭
龢	龢
鳤	䲘
亹	亹
籥	籥
鼷	鼷
𫚭	鱲
玃	玃
醾	醾
齇	齇
觿	觿
蠼	蠼
